a	art.一（人，事，物），每一，任何一
abandon	n.放任，放纵 v.离弃，抛弃，放弃，停止（支持或帮助）
ability	n.(办事)能力，才能，才干
able	a.有才能的，能够的
abortion	n.流产；人工流产
about	关于
above	prep.在…之上
abroad	ad.海外；到处；广泛
absence	n.缺席；缺乏，缺少
absolute	n.绝对真理 a.绝对的，完全的；十足的，确实的
absolutely	ad.（强调真实无误）绝对地
absorb	vt.吸收(水、热、光等)；吸引（注意），吞并，同化，理解，掌握
abstract	a.抽象的 n.摘要，梗概 vt.提取；摘录要点
abuse	n.滥用，妄用，恶语，虐待 vt.滥用（以致危害的），妄用权力，虐待
academic	n.高校教职人员 a.(高等)教学的；学术的
accelerate	vt.(使)加速；(使)增速
accent	n.口音，着重点，重音 v.强调
accept	v.接受，认可
acceptable	a.值得接受的
acceptance	n.接受，认同
access	n.通道，入径，(使用或见到的)机会，权力 v.访问，存取，使用
accessible	a.可接近的；可进入的；可使用的，易懂的，易打交道的
accident	n.意外的事件；交通事故，不测
accommodate	vt.向…提供住处；对...予以照顾性考虑，容纳，顾及
accompany	vt.陪伴，陪同；和...一起发生(存在)，用钢琴伴奏
accomplish	vt.完成(任务等)
accomplishment	n.成就，才艺，专长，完成
according	v.给予，授予(权力地位等)，(与...)一致 adj.依照(用于习语中)
account	n.叙述；报告；户头；帐目，赊欠 v.认为是，视为
accountability	n.责任，负有责任，衡量计算，(档案)保管责任
accounting	n.会计(学) v.认为是，视为
accuracy	n.精确（性），准确（性）
accurate	a.准确的；精密的
accurately	ad.精确地，准确地
accusation	n.起诉，控告，谴责，告发
accuse	v.控告，控诉，谴责
achieve	vt.完成，实现；(凭长期努力)达到，得到(目标，地位，标准)
achievement	n.完成，达到；成就，成绩，功绩
acid	n.酸 a.酸的，尖刻的
acknowledge	vt.(公开)承认；感谢，告知收悉
acquire	vt.(通过努力、能力、行为表现)取得；获得；学到，习得
acquisition	(知识、技能等的)获得，得到，(多指贵重的)购得物，购置，收购
across	prep.&amp;ad.由这边到那边；在…对面；横过
act	n.行为，举动，法案 v.做事，行为，举止，假装
action	n.行动；动作过程，起诉 v.务必做，确保处理(某事)
active	n.主动语态 a.(尤指体力上)活跃的，定期进行的，起作用的
actively	adv．积极地，活跃地，主动地
activist	n.激进分子，积极分子
activity	n.活动，热闹状况，活跃
actor	n.男演员
actress	n.女演员
actual	a.真实的；实际的，(强调事情最重要的部分)真正的
actually	ad.(强调事实)真实地；实际地，(表示惊奇)居然，竟然，礼貌的纠正他人
ad	(=Anno Domini)［拉］公元后 , n.广告
adapt	vt.改编
add	v.添加；增加；加起；做加法
added	a.多用的，增加的
addition	n.附加物
additional	a.附加的；补充的
address	vt.用(某姓名或头衔)称呼(某人)
adequate	a.足够的
adjust	v.调节
adjustment	n.调整
administer	vt.掌管,料理；施行；给予
administration	n.行政；管理，经营；行政机关；政府
administrative	a.管理的, 行政的
administrator	n.管理者
admire	v.钦佩；佩服；赞赏
admission	n.准许进入；准许加入；入场费
admit	vt.承认
adolescent	n.青少年；青春期的
adopt	vt.收留
adoption	n.采取，采纳，采用
adult	n.&amp;a.成人(的)
advance	n.预付；借贷
advanced	a.高级的，高难度的，高深的
advantage	n.利益；便利；优势
adventure	n.惊险
advertising	n.广告，促销宣传品
advice	n.劝告
advise	vt.忠告；劝告
adviser	n.顾问
advocate	n.辩护者；律师；提倡者 vt.提倡，拥护
aesthetic	a. 美学的，有关美的
affair	n.事，事情，事件
affect	vt.影响
afford	v.花得起
afraid	Afraid adj.(表语)怕，害怕 , adj．害怕的
African	a.非洲的 n.非洲人
African-American	非洲裔美国人(指美国黑人)
after	prep.在…之后
afternoon	n.下午
afterward	ad.然后
again	ad.再
against	prep.逆；违反
age	n.年龄
agency	n.公私机构；代理处；经销处
agenda	n.意图，计划
agent	n.经纪人；媒介物
aggression	n.进攻；侵略；侵犯；侵害
aggressive	a.(好)侵略的；侵略性的；积极进取的
ago	a.&amp;ad.以前
agree	v.同意；相合；一致
agreement	n.相合；一致；同意；契约；协议
agricultural	a.农业的
agriculture	n.农业；农事
ah	int.[表痛苦，惊奇]
ahead	ad.朝前；在前
aid	vt./n.帮助；援助
aide	n.助手，副官
AIDS	n.艾滋病，即获得性免疫缺损综合症
aim	v.瞄准 n.瞄准；目的
air	n.空气
aircraft	n.飞机，航空器
airline	n.航空公司
airplane	n.飞机
airport	n.航空站，机场
aisle	n.过道，走廊
alarm	n.惊慌；惊恐；警报；警号
album	n.粘贴相片、邮票等的空白的簿册；唱片集
alcohol	n.酒精；酒
alien	adj.奇怪的，不同性质的
alike	a.一样的，相似的
alive	a.活的
all	ad.全部；都
allegation	n.(有待证实的)指控
alleged	a.被指控的，嫌疑的
allegedly	ad.据说
alley	n.弄，小巷
alliance	n.同盟，联盟
allow	vt.允许
ally	n.同盟者；同盟国
almost	ad.几乎
alone	ad.独自；单独
along	prep.沿着；往前
alongside	prep.&amp;ad.和(...)在一起；在(...)旁边
already	ad.已经
also	ad.也
alter	v.改变，变更
alternative	n.供选择的东西；供替代的抉择
although	conj.虽然
altogether	ad.完全地，一共，总共，总而言之
aluminum	n.[化]铝
always	ad.总是
AM	am v.是(接在&quot;I&quot;后面) , A.M.(a.m.)上午
amazing	a.惊人的；惊奇的
ambassador	n.大使
ambition	n.抱负；野心
ambitious	a.有雄心的；野心勃勃的
amendment	n.对文件等所作的次要的修改或增添
American	american n. 美国人 , a.美洲的 n.美国人
amid	prep.在…之中
among	prep.在…之中
amount	n.数量
analysis	n.分析
analyst	n.分析家，分析员，化验员
analyze	vt.分析
ancestor	n.祖先，祖宗
ancient	a.古代的，古老的
and	AND 逻辑与 , conj.和；又；而且
angel	n.天使
anger	n.愤怒 vt.使发怒，激怒 vi.发怒
angle	angle v.(用暗示等方法)取得，谋取 n.角，角度 , n.盎格鲁人
angry	a.生气的
animal	n.动物 a.动物的
ankle	n.踝；踝关节
anniversary	n.周年纪念日
announce	v.宣布，通告
announcement	n.通告，布告，告示
annual	n.年刊，年报，一年生植物 a.每年的，一年一次的
annually	ad.一年一次地
anonymous	a.匿名的，无名的，姓氏不明的
another	a.另外的
answer	vt.回答
anticipate	vt.预期
anxiety	n.焦虑
anxious	a.担心的；渴望的
any	adj./pron.任何；任何一个；一些
anybody	pron.任何人
anymore	ad.不再, 再也不
anyone	pron.任何一个
anything	pron.任何事
anyway	ad.究竟；无论如何
anywhere	adv.无论何处，什么地方
apart	ad.分离，分开
apartment	n.房间，公寓
apologize	vi.道歉，谢罪
apology	n.道歉，认错，谢罪
apparent	a.显然的，外观上的
apparently	ad.显然，似乎
appeal	vi.引起兴趣；有感染力；有吸引力
appear	n.&amp;v.出现，问世；好像是
appearance	n.外表
apple	n.苹果 , n.苹果公司
application	n.申请
apply	vi.申请，请求；适用 vt.应用，运用
appoint	vt.任命，委任(as)；约定，指定
appointment	n.任命；约定
appreciate	vt.欣赏，鉴赏；感谢，感激
appreciation	n.欣赏；感激
approach	n.方式，方法 v.靠近，接近，接洽，要求
appropriate	a.适宜的
approval	n.批准，通过；赞成，同意
approve	vt.赞成，同意；批准，核准
approximately	ad.近似地，大约地
Arab	Arab n.阿拉伯人 , n. 阿拉伯人
architect	n.建筑师，设计师，缔造者，创造者
architecture	n.建筑术；建筑学
area	n.地区
arena	n.(供竞技、表演等用的)场地
argue	vt.争辩
argument	n.争论；辩论
arise	vi.出现，发生；(from)由…引起
arm	手臂
armed	adj.武装的，持枪的
army	n.军队，陆军，大群，大批
around	prep.在…四周 adv.各处
arrange	v.作安排，筹划
arrangement	n.安排
array	n.列阵
arrest	vt.逮捕
arrival	n.到达
arrive	v.到来，到达；达成(at)
arrow	n.箭
art	art n.艺术 , 美术课
article	n.文章，论文；条款，条文；物件；冠词
articulate	vt.明确有力地表达
artifact	n．典型产物
artificial	a.人工的，人造的；假的，矫揉造作的
artist	n.画家，艺术家
artistic	a.艺术的；艺术家的；富有艺术性的
as	v.有;存在;位于;在(某处);在...发生
ash	n.灰；灰烬，灰堆
Asian	n.亚洲人 adj.亚洲的，亚洲人的
aside	ad.在旁边；到(向)一边
ask	vt.问
asleep	a.睡着的，睡熟
aspect	n.方面
ass	n.笨蛋，傻瓜；驴
assault	n.攻击，袭击；(军)冲击，突击，强击
assemble	vt.集合
assembly	n.组装；集会
assert	vt.宣称，断言
assess	vt.估计，估价；评估
assessment	n.估定；查定；估计数
asset	n.资产，所有物
assign	assign v.指派，指定；分配；过户；转让 , 分配
assignment	n.(布置的)作业
assist	v.帮忙
assistance	n.help, aid 协作; 援助; 帮助
assistant	n.助理，助手
associate	vt.联想
associated	关联的
association	n.联想
assume	vt.假设，主观认为
assumption	n.假定，设想；承担，采取
assure	vt.使确信，使放心(of)；向…保证
astronomer	n.天文学家
at	在
athlete	n.运动员
athletic	a.运动的；运动员的
atmosphere	n.大气；空气
attach	vt.把…给予；系，贴
attack	v.攻击
attempt	v. n.试图，尝试
attend	v.出席
attendance	n.参加；出席
attention	n.注意，留心
attitude	n.态度，看法
attorney	n.(业务或法律事务上的)代理人；辩护律师
attract	v.吸引，引诱
attraction	n.吸引，魅力
attractive	a.吸引人的；有魅力的
attribute	vt.把…归因于
auction	n.／vt.拍卖
audience	n.观众；听众；陈述意见的机会
aunt	n.伯母，婶母，姑母，舅母，姨母
author	n.作者
authority	n.权威；权力
authorize	vt.授权，委任；许可，批准
auto	n.汽车
automatic	a.自动的
automatically	ad.自动地；无意识地
automobile	n.汽车
autonomy	n.自治(权)；自主
availability	n.有效(性)；可得性
available	a.可利用的，可获得的
average	adj.平均的，平常的
avoid	vt.避免
await	vt.等待
awake	a.&amp;v.醒着的；唤醒，醒来，唤起
award	vt.判给；授予
aware	a.知道的；意识到的
awareness	n.意识，觉悟；懂事，明智
away	ad.在远处
awful	adj.极坏的，糟糕的，威严的，可怕的
baby	n.婴儿
back	adv.以前
background	n.背景
backyard	n．后院
bacteria	n.细菌
bad	坏的
badly	adv.坏，恶劣的，严重地，非常
bag	n.书包；提包；袋子
bake	v.烤，烘
balance	n.平衡 v.平衡，权衡
balanced	adj.平衡的；协调的
ball	ball n.球；圆珠 , n.鲍尔(姓)
balloon	n. 气球，玩具气球
ballot	n.投票；投票总数；选票 v.投票表决
ban	vt.禁止，取缔 n.禁止；禁令
banana	香蕉
band	n.一帮，一群；带，带形物；波段
bank	n.银行
banker	n.银行家；银行高级职员
banking	n.银行业
bar	n.酒吧间；条，杆，栅，栏
bare	a.不铺地毯的；赤裸的；光秃的
barely	ad.仅仅，勉强；几乎没有
barn	n.谷仓；牲口棚；库房
barrel	n.桶
barrier	n.障碍；障碍物
base	n.底部；基数
baseball	n.棒球(运动)
basement	n.地下室
basic	adj.基本的，基础的 , n．(电脑)初学者通用符号指令码
basically	ad.基本上，从根本上说
basis	n.基础，根据；主要成份；军事基地
basket	n.篮子
basketball	n.篮球
bat	n.球棒，球拍
bath	Bath 巴斯(英国城市) , n.浴，洗澡；浴缸
bathroom	n.浴室
battery	n.电池(组)；一组，一系列
battle	n.战役
bay	n.海湾，口岸，湾
be	v.是
beach	n.海滨
beam	vi.面露喜色；高兴地微笑
bean	n.豆；豆科植物
bear	熊
beard	n.胡须
beast	n.野兽；牲畜
beat	v.敲打；打
beautiful	a.美的，美好的；漂亮的
beauty	n.漂亮
because	conj.因为
become	vi.成为
bed	n.床
bedroom	n.卧室
bee	n.蜜蜂
beef	n.牛肉
beer	n.啤酒
before	adv.以前，从前
beg	v.乞讨；请求，恳求
begin	v.开始
beginning	n.开始，开端；起源
behalf	n.利益
behave	vi.举动，举止；表现
behavior	n.行为
behavioral	a.行为的
behind	prep.在…之后
being	n.存在
belief	n.相信；信念，信仰
believe	v.相信
bell	n.铃
belly	n.肚，腹部
belong	v.属于
below	prep.在…下面，数量少于，级别低于 adv.下级
belt	n.皮带
bench	n.长凳
bend	n.弯曲 v.弯曲
beneath	prep.在…下面(或底下)，adv.在下面，在底下
benefit	vt.有益于
beside	prep.在…旁边
besides	ad.此外
best	a.最好的；最大的
bet	vt.确信；用…打赌
better	vt.改善
between	prep.在…之间
beyond	prep.在/到…较远的一边，超出，超过
bias	n.偏见
Bible	Bible n.圣经 , n.《圣经》；得到权威支持的典籍
bicycle	n.自行车
bid	v.祝，表示；出价，投标
big	a.大
bike	自行车
bill	Bill 比尔(男名) , n.法案；议案；账单
billion	n.十亿
bind	vt.(bound，bound)捆绑，捆扎
biography	n.个人经历；传记
biological	a.生物学(上)的
biology	n.生物学
bird	n.鸟，禽
birth	n.出生，出身，出世
birthday	n.生日
bishop	n.主教
bit	n.一点，一片，一些
bite	vt./vi./n.咬，叮，蜇
bitter	a.苦的，痛苦的
black	a.黑色的
blade	n. 刀刃，刀片；叶片
blame	v.&amp;n.责备，怪，怨；责任，过失
blank	a.空白的；空着的；茫然的，无表情的
blanket	n.毛毯
blast	n.疾风，强风；爆炸 vt.炸，炸掉
blend	n.混合物
bless	vt.赐福；祝福
blessing	n.幸事，喜事
blind	adj.盲的，瞎的
blink	n./v.眨眼睛，一瞥，闪亮，闪烁
block	n.&amp;v.阻塞，封锁，木块
blond	adj.白肤金发碧眼的，浅色的，金黄色的
blood	n.血，血液
bloody	a.血腥的，血污的
blow	v.&amp;n.吹，吹气，吹响(乐器)，打击
blue	a.&amp;n.蓝色的，青色的；蓝色，青色
board	n.木板，委员会 v.用木板盖，上船，包饭
boast	vi.吹牛，自夸
boat	n.小船
body	n.天体
boil	n.沸点
bold	a.大胆的
bolt	n.螺栓；(门或窗)插销，闩 vt.闩，栓住
bomb	n.炸弹
bombing	n.轰炸
bond	n.联结物；联系
bone	n.骨，骨骼
bonus	n.奖金
book	书
boom	vi.迅速发展，兴盛
boost	n.促进，激励；一抬；一推 vt.推动，增强
boot	n.靴
booth	n.小(房)间；公用电话亭
border	n.边，边缘，边境
boring	a.令人厌烦的
born	a.出生的，产生的；天生的
borrow	v.借
boss	n.老板；上司
both	prep./adj.两个(都)，两者(都)
bother	a.打扰，烦扰
bottle	n.瓶子
bottom	n.底，底部，基础，根基
bounce	vi.弹起;弹跳
boundary	n.分界线，边界
bow	n.弓；蝴蝶结；鞠躬，点头
bowl	n.碗，钵，碗状物
box	n.箱子，盒子
boy	n.男孩
boyfriend	n.男朋友
brain	n.大脑，智力
brake	n.刹车
branch	n.分支
brand	n.商标，牌子
brave	a.勇敢的
bread	n.面包
break	v.&amp;n.打破；破碎；折断；休息时间
breakfast	n.早饭，早餐
breast	n.胸脯，乳房
breath	n.呼吸
breathe	v.呼吸
breathing	n.呼吸
breeze	vi.轻快地行动
brick	n.砖
bride	n.新娘
bridge	n.桥，桥梁
brief	n.摘要
briefly	adv.简短地
bright	a.聪明的
brilliant	a.辉煌的；卓越的
bring	vt.带来
British	British a.英国(人)的 n.英国人 , adj. 英国的
broad	a.宽的，阔的；广泛的
broadcast	n./vt./vi.广播，播音
broken	a.被打碎的，骨折的
broker	n.经纪人，掮客
bronze	n.青铜；青铜色，古铜色；青铜制品，铜牌
brother	n.兄；弟
brown	Brown (人名) , a.棕色的
brush	n.矮灌木丛；断落的树枝
brutal	a.残忍的；残酷的
bubble	v.使...破、裂、碎，损坏
buck	n.(美国口语)元
bucket	n.水桶；一桶之量
buddy	n.a close friend好朋友
budget	n.预算 vt.把…编入预算；安排，预定
bug	n.臭虫，虫子
build	vt./vi.建造；建设
builder	n. 建立者
building	n.建筑物
bulb	n.灯泡; 球根; 球状物
bulk	n.大量，大块
bull	Bull (姓)布尔 , n.公牛；雄的象
bullet	n.子弹
bunch	n.(一)束，(一)串
burden	n.重负；负荷
bureau	n.衣柜
burn	v.烧
burning	a.强烈的，热烈的，迫切的
burst	n.&amp;v.破裂，爆炸
bury	v.埋，安葬
bus	n.公共汽车
bush	n.灌木，灌木状的，荒野，(人)布什
business	n.行业，生意；事务，业务，职责
businessman	n.商人
busy	a.忙，忙碌；繁忙
but	conj.但是
butt	n.柄，底端，蒂头
butter	n.储藏柜，陈列柜
butterfly	n.蝴蝶
button	n.按钮，纽扣
buy	vt.买
buyer	n.购买者；买主
by	ad.在附近
cab	n.出租马车、汽车
cabin	n.小木屋；茅舍
cabinet	n.贮藏橱
cable	n.电缆
cage	v.计算；核算；预测；推测
cake	蛋糕
calculate	vt.计算；估计；计划
calculation	n.计算，计算结果；仔细考虑
calendar	n.日历，历法
call	v.呼叫
calm	a.平静，镇静，沉着
camera	商业;
camp	n.&amp;v.野营，营地，帐篷；设营，宿营
campaign	n.运动
campus	n.大学；校园
can	CAN 加拿大 , 能，能够
Canadian	Canadian a.加拿大(人)的 n.加拿大人 , n. 加拿大人
cancel	vt.offset 取消，撤消；删去
cancer	n.癌
candidate	n.候选人，候补者；应试者
candle	n.蜡烛
candy	n.糖果
canvas	n.帆布画布；油画
cap	n.帽子
capability	n.能力
capable	a.有能力的，有才能的；能…的(of)
capacity	n.能力；容量
capital	n.首都
captain	n.船长，机长
capture	vt.捕获；夺得，占领 n.捕获，捕获物
car	n.小轿车
carbohydrate	n.碳水化合物；[pl.]淀粉质食物
carbon	n.碳
card	n.卡
care	care n.照料 v.管理 , n.照料；保护；小心
career	n.职业；生涯
careful	a.小心的
carefully	adv.小心地；仔细地
cargo	n.船货，货物
carpet	n.地毯
carrier	n.带菌者
carrot	n.胡萝卜
carry	v.搬运，运送，携带
cart	n.双轮运货马车
cartoon	n.漫画，讽刺画
carve	vt.雕刻；雕刻成；靠勤奋创(业)
case	n.情况，事实；病例；案件；箱，盒
cash	n.现金
casino	n.赌场
cast	v.投，掷，抛
casual	a.偶然的，碰巧的
casualty	n.伤亡人员；受害人，损失的东西
cat	cat n.猫 , 电子计算机横断层扫描
catalog	n.目录
catch	vt.捕捉
category	n.门类，种类；范畴；部门
Catholic	a.(兴趣等)广泛的，(人)宽厚的 , n.天主教教徒
cattle	n.牛
cause	n.&amp;v.原因，理由，缘故；引起，起因
cave	n.山洞，窑洞；地窑
cease	vt./vi./n.停止，结束
ceiling	n.天花板
celebrate	v.庆祝
celebration	n.庆祝
celebrity	n.名流；名人
cell	n.细胞
cemetery	n.公墓；墓地
center	n.中心，中央
central	a.中心的
century	n.世纪，一百年
CEO	n.chief executive officer首席执行官
ceremony	n.典礼，仪式；礼节，礼仪
certain	a.确定的
certainly	ad.当然
chain	n.一系列；链子
chair	n.椅子
chairman	n.主席
challenge	n.挑战
chamber	n.房间，寝室；会议厅；议院；会所
champion	n.冠军
championship	n.冠军身份；冠军称号
chance	n.机会
change	n.改变，找头 v.改变，换车
channel	n.频道；航道；渠道 vt.通过…获得，传送
chaos	n.混乱(状态)
chapter	n.章，回，篇
character	n.性格，品质；特性；人物；符号，(汉)字
characteristic	a.特有的，典型的 n.特性，特征
characterize	v.以...为特征；描述...的特征，描绘
charge	vt.索价；指控 n.价钱，费用；负荷
charity	n.慈善
charm	n.魅力；妩媚
chart	n.图(表)
charter	n.宪章
chase	v.追逐，追赶
cheap	a.便宜，贱
cheat	vt.欺骗，骗取 vi.行骗，作弊 n.欺骗；骗子
check	v.&amp;n.检查
cheek	n.面颊
cheer	v.&amp;n.喝采，欢呼；(使)振奋
cheese	n.干酪，奶酪
chef	n.(餐馆等的)厨师长，厨师
chemical	a.化学的
chemistry	n.化学
chest	n.木盒子
chew	vt./vi.咀嚼
chicken	n.小鸡
chief	n.首领
child	n.孩子
childhood	n.童年
chill	v.(使)感到冷；(使)冷
chin	n.下巴
Chinese	Chinese n.中国人；中文；中国的语言 a.中国的 , adj. & n. 中国的；中国人
chip	n.片屑；薄片；电子集成电路片，芯片
chocolate	n.巧克力(糖)
choice	n.选择，选择机会
cholesterol	n.胆固醇
choose	vt.选择
chop	n.(连骨的)块肉
Christian	Christian a.基督教的 , a./n.基督教的；基督教徒
Christianity	n.基督教；基督教义
Christmas	Christmas n.圣诞节 , n. 圣诞节
chronic	adj.长期的；经常的；慢性的
chunk	n.一大块，一厚块 vt.分块，组块
church	church n.教堂 , n.教会
cigarette	n.香烟，纸烟
circle	v.环绕
circuit	n.电路
circumstance	n.情况，环境
cite	vt.举出；引用
citizen	n.公民，市民，居民
citizenship	n.公民身份；公民的权力与义务
city	n.城市
civic	a.公民的，市民的
civil	a.国民的，民用的；国内的，民间的
civilian	a.&amp;n.平民(的)
civilization	n.文明
claim	vt.对...提出要求；声称；主张 n.要求
class	n.班
classic	a.经典的，典型的
classical	a.古典的，经典的
classify	vt.分类，分级
classroom	n.教室
clay	n.粘土
clean	a.&amp;v.清洁，干净；弄清洁
clear	vt.跳过
clearly	ad.清楚地，明白地
clerk	n.办事员，公务员；(美)店员
click	v.发出咔哒或喀嚓声
client	n.客户；委托人
cliff	n.悬崖，峭壁
climate	n.气候; 特殊气候地带
climb	v.&amp;n.爬，攀登
cling	vi.紧握着；粘着
clinic	n.诊所
clinical	a.临床的
clip	n.夹子，别针；弹夹；片断vt.夹住；修剪
clock	n.时钟
close	Close 关闭 , vt.关，闭
closed	adj.关着的
closely	ad.紧密地；严密地，密切地
closest	a.最亲的(为close的最高级)
closet	n.壁橱，橱柜
cloth	n.衣料
clothes	n.衣服
clothing	n.服装；衣着
cloud	n.云，云状物
club	n.棍棒；球棒；俱乐部
clue	n.线索，提示
cluster	n.串，簇；群，组vi.群集，丛生vt.集中
coach	n.四轮大马车
coal	n.煤
coalition	n.结合体，同盟；结合，联合
coast	n.海岸；海滨
coastal	a.海岸的，沿岸的
coat	n.外套
cocaine	n.可卡因
code	n.代码，密码
coffee	n.咖啡
cognitive	a.认知的
coin	n.硬币
cold	a.&amp;n.冷，冷淡；寒冷；感冒
collaboration	n.合作，协作；勾结
collapse	vt./vi./n.(使)倒塌，(使)崩溃；瓦解
collar	n.领子
colleague	n.同事
collect	v.收集，收(税等)
collection	n.收集；收集的东西
collective	adj.集体的
collector	n.收集者；搜集者；收藏者
college	n.学院，大学
colonial	a.殖民地的
colony	n.殖民地
color	n.颜色
colorful	a.艳丽的；丰富多彩的
column	n.柱，圆柱；栏，专栏(文章)
columnist	n.专栏作家
combat	v.与…战斗，与...斗争
combination	n.结合
combine	v.结合，联合，化合，联结
combined	a.结合的
come	vi.来
comedy	n.喜剧；喜剧性事件
comfort	v.&amp;n.慰问，安慰，安逸，舒适
comfortable	a.舒适的
coming	a.正在到来的，即将来到的 n.来到，到达
command	vt.指挥
commander	n.a person in charge; leader 指挥员
comment	n.评论 vi.注释，评论
commercial	a.商业的, 贸易的
commission	v.委托
commissioner	n.(政府厅、局、处等部门)专员；长官；委员
commit	vt.指定…用于
commitment	n.承担的责任或义务，承诺
committee	n.委员会
commodity	n.日用品，商品，物品
common	a.共同的，共有的，共用的
commonly	ad.通常地，常常地
communicate	vi.交流意见、思想等
communication	n.通讯，交流；传达；通讯联系，交通工具
community	n.社区；共同体
companion	n.同伴，同事；［天］伴星(=～star)
company	n.公司；同伴，陪伴
comparable	a.相当的，同类的
compare	v.比较，相比
comparison	n.比较，对比
compel	vt.强迫，迫使
compelling	a.激发兴趣的，有强烈吸引力的；令人信服的
compensation	n.补偿(赔偿)；补偿(赔偿)金
compete	vi.竞争，比赛
competition	n.竞争，比赛
competitive	a.竞争的，比赛的
competitor	n.竞争者；对手
complain	n. 抱怨 v.抱怨
complete	a.全部的
completely	ad.全，完全地
complex	a.复杂的，组合的 n.综合体
complexity	n.复杂(性)
compliance	n.遵守
complicated	a.难懂的；复杂的
comply	v.服从，遵从
component	n.(组)成(部)分；部件a.组成的，构成的
compose	vt.创作(乐曲)
composition	n.作文；写作
compound	a.复合的
comprehensive	a.广泛的，综合的
comprise	vt.构成，组成
compromise	vi.背弃；妥协
computer	n.电脑，计算机
concede	v.承认，承认...为真(或正确)
conceive	vt.怀(胎)；构思
concentrate	vt.集中，聚集；浓缩 vi.集中，专心
concentration	n.集中
concept	n.概念；观念
conception	n.概念，观念，想法
concern	vt.涉及，关系到
concerned	a.有关的；关切的，担心的
concerning	prep.关于，有关
concert	n.音乐会
conclude	vt.推断出，推论出；结束vi.结束，终了
conclusion	n.结论，推论
concrete	n.混凝土
condemn	v.谴责；判刑
condition	n.水管；导管；渠道
conduct	n.行为；管理
conference	n.会议
confess	vt.承认；坦白
confession	n.坦白；忏悔
confidence	n.信任，信心
confident	a.自信的
confirm	vt.证实，肯定；确认
conflict	n.争论，抵触，冲突 vi.冲突，抵触
confront	vt.面对，遭遇；正视，对抗
confrontation	n.对抗，冲突
confuse	vt.搞乱，使糊涂
confusion	n.混乱，慌乱；混淆
Congress	Congress n.美国国会 , n.立法机关
congressional	a.美国国会的，议会的
connect	v.连接
connection	n.连接，关系
conscience	n.良心，道德心
conscious	a.意识到的，感到的；神志清醒的
consciousness	n.awareness 意识，觉悟；知觉
consecutive	a.连续的，连贯的
consensus	n.合意；(意见等的)一致
consent	v.同意
consequence	n.后果；重要性
consequently	ad.所以，因此
conservation	n.保存；保护
conservative	n.(美国)保守党 , a.保守的；小心谨慎的；防腐的 n.保守的人
consider	vt.考虑，细想；认为 vi.考虑，细想
considerable	a.值得考虑的，重要的；相当大或多的
considerably	ad.相当地
consideration	n.考虑；体谅，照顾
consist	vi.组成(of)
consistent	a. in agreement 前后一致的
consistently	ad.始终如一地；一贯地
conspiracy	n.阴谋，密谋；阴谋集团，阴谋帮派
constant	a.永恒的，经久不变的；经常的 n.常数
constantly	ad.不断地；经常地
constitute	vt.形成；构成；组建；选派
constitution	n.法规，宪法，章程；制定；设立；组成
constitutional	a.宪法规定的；合乎宪法的
constraint	n.强制；强制因素，制约条件
construct	vt.构成，形成
construction	n.建造；建筑；建筑物
consult	v.商量，参考
consultant	n.顾问
consume	vt.消耗；消费
consumer	n.消费者，用户
consumption	n.消费(量)
contact	n.接触 vt.与…接触
contain	vt.包含，容纳
container	n.容器
contemplate	vt.(默默地)注视，凝视
contemporary	a.当代的, 同时代的
contend	v.竞争；争论；坚决主张
content	n.内容
contest	n.竞争，比赛；争夺，竞争；争论，争辩
context	n.上下文，语境
continent	continent n.大陆 , n.大陆，洲
continue	v.连续，继续
continued	过去分词 v.持续; 继续存在; 不断发生 a.继续的，连续的
continuous	a.连续的
contract	n.合同，契约 v.订(约)；承包；收缩，缩小
contractor	n.立约人；承包人
contrast	n.对比，对照 vi.形成对比 vt.把…与…对比
contribute	vi.贡献
contribution	n.捐献；贡献
contributor	n.捐助人；纳税人
control	vt./n.控制，支配；克制，抑制
controversial	a.引起争议的
controversy	n.争论，争议
convenience	n.便利，方便
convention	n.习俗，惯例
conventional	a.惯例的，常规的；(艺术等)因袭的
conversation	n.谈话，会话
conversion	n.转变，变换；改变信仰，皈依
convert	vt./vi.(使)转换，(使)变化
convey	vt.转达，传达
convict	vt.证明…有罪(of)；宣判 n.罪犯
conviction	n.深信, 确信, 定罪, 宣告有罪
convince	vt.使确信，使信服
convinced	adj.被说服的
cook	Cook 库克(人名) , n.厨师
cookie	n.a sweet cookie曲奇饼
cooking	n.烹饪
cool	a.凉爽
cooperate	v.合作，协作；配合
cooperation	n.合作，配合
cooperative	a.有合作意向的；合作的n.合作社(企业等)
coordinate	vt.调整
coordinator	协调程序
cop	n.巡警
cope	vi.(妥善地)应付或处理
copy	n.&amp;v.抄件，副本；模仿
cord	n.(电)软线，粗线
core	n.中心；核心；(苹果、梨等果实的)果心
corn	n.玉米
corner	n.角落
corporate	a.法人团体的，公司的；全体的，共同的
corporation	n.有限公司
correct	a.正确的 v.改正 纠正 批改
correctly	ad.正确的，得体的
correlation	n.相互关系，关联
correspondent	n.对应物；新闻通讯员，记者，通信者
corridor	n.走廊，回廊，通路
corruption	n.腐化；道德败坏
cost	n.&amp;v.成本，费用，代价；值，花费
costly	a.昂贵的，代价高昂的
costume	n.(一个地区、一个时期流行的)服装；戏装
cottage	n.村舍；小屋；别墅
cotton	n.棉花，棉纱，棉制品
couch	n.长沙发椅
could	can的过去式
council	n.理事会；委员会
counsel	vt.提出建议(或劝告)
counseling	n.顾问服务
counselor	n.顾问
count	v.数，计算
counter	n.讨价还价的本钱；回击，反击
counterpart	n.对应的人(或物)；对手(方)
country	n.国家；农村，乡间
county	n.(英国)郡；县
coup	n.政变`突然的一击
couple	n.对，双，夫妇
courage	n.勇气
course	n.进程，过程，课程
court	n.法院 v.求爱
courtroom	n.审判室
cousin	n.堂(表)兄弟，堂(表)姐妹
cover	n.封面 vt.覆盖；包括；涵盖
coverage	n.覆盖，总括；承保范围；新闻报道
cow	n.母牛
crack	n.裂缝，裂口 vi.爆裂，破裂
craft	n.工艺；手艺，行业
crash	v.(使)哗啦一声坠落(或倒下，破碎) n.坠落
crawl	vi.&amp;n.爬(行)
crazy	a.疯狂的；愚蠢的
cream	n.膏状物
create	vt.创造
creation	n.创造
creative	a.创造性的
creativity	n.创造性
creature	n.创造物; 生物; 动物
credibility	n.可靠性，可信度
credit	认为（某人）有（某种优点或成就等）
crew	n.全体船员，全体机务人员
crime	n.罪，罪行；犯罪
criminal	a.犯罪的，违法的 n.罪犯，犯人
crisis	n.危机
criteria	标准
critic	n.评论家；批评者
critical	a.挑剔的，苛求的
criticism	n.批评，指责
criticize	vt.批评
crop	n.农作物，庄稼；收成
cross	n.&amp;v.十字形，十字架；越过，穿过
crowd	n.群，人群 vi.聚集，群集
crowded	a.拥挤的
crucial	a.决定性的，关键的
cruel	a.残忍的
cruise	v.巡航；航游；缓慢巡行 n.海上航游
crush	vt.压碎，碾碎；镇压，压倒
cry	v.&amp;n.叫，喊；哭泣
crystal	n.水晶；晶粒 a.清澈透明的，晶体的
Cuban	n.&amp;a.古巴(人)的
cue	vt.给…提示；指示 n.暗示；信号
cultural	a.文化上的，文化的；修养的
culture	n.文化；文明
cup	n.杯子
cure	n.&amp;v.治愈，医治
curiosity	n.好奇心
curious	a.奇怪的
currency	n.通货，货币
current	n.潮流；涌流，电流 a.当前的，通行的
currently	ad.目前
curriculum	n.课程，大纲
curtain	n.窗帘
curve	n.曲线，弯曲 vt./vi.(使)弯曲，(使)成曲线
custody	n.监管，监护
custom	n.习俗，风俗，(个人)习惯
customer	n.顾客，消费者
cut	vt.割；切
cute	a.聪明的, 伶俐的
cycle	n.周期；循环
dad	Dad n.爹爹；爸爸(俗) , n.爸爸(非正式用语)
daily	a.每日的
dam	n.坝，堤
damage	vt.损坏 n.损坏
damn	int.该死，他妈的 vt.指责，贬斥，诅咒
dance	v.&amp;n.跳舞；舞蹈，舞会
dancer	n.跳舞的人，舞蹈者
dancing	跳舞
danger	n.危险
dangerous	a.危险的
dare	vt.挑战
dark	a.黑暗的 n.黑暗
darkness	n.黑暗；晦暗
data	n.资料，数据
database	n.数据库
date	n.&amp;v.日期；日子；年代；注日期
daughter	n.女儿
dawn	n.黎明
day	n.日
dead	a.死的
deadline	n.最后期限
deadly	a.致命的，致死的
deal	v.&amp;n.处理，安排，应付(with)；数量
dealer	n.商人，做买卖的人
dear	a.亲爱的
death	n.死，死亡
debate	vt.辩论
debris	n.(破坏物的)碎片，废墟;[地理]岩屑，(冰川积聚的)碎石
debt	n.债务，欠债
debut	n.首次演出，初次露面
decade	n.十年，十年期
decent	a.合宜的；得体的
decide	v.决定，下决心
decision	n.决定，决心，果断
deck	n.音响设备中放光盘或磁带的装置；甲板
declare	v.宣布，宣告
decline	vi.下降；衰退vt.拒绝 n.下降；衰落
decorate	vt.装修，装饰
decrease	v.&amp;n.减少
dedicate	vt.献给; 献身于
deem	vt.认为，相信
deep	a.深的
deeply	ad.深深地
deer	n.［单复同形］鹿
defeat	vt.&amp;n.击败
defend	v.防卫
defendant	n.被告
defender	n.防守队员
defense	n.防御；保卫，防卫
defensive	a.防御的
deficit	n.赤字，亏空，亏损
define	v.explain the meaning of 界定
definitely	ad.明确地，干脆地
definition	n.定义
degree	n.程度
delay	v.&amp;n.延迟
deliberately	ad. on purpose 故意地
delicate	a.细软的，纤细的；精美的；微妙的
delight	n.&amp;v.快乐，高兴；使快乐
deliver	vt.交付；递送
delivery	n.投递；送交
demand	vt.&amp;n.要求
democracy	n.民主政治，民主主义
Democrat	Democrat n.（美）民主党党员 , n.(美国)民主党人
democratic	a.民主的
demographic	a.人口的，人口统计的
demonstrate	vt.论证，证明；示范；显示 vi.示威游行
demonstration	n.(情绪的)显示，表露；示威游行
denial	n.否定；拒绝相信
dense	a.密集的，稠密的，浓密的
density	n.密集度，稠密度；［物][化］密度
deny	vt.否认；拒绝给予
depart	vi.离开
department	n.部，部门，系
departure	n.离开，启程，出发
depend	v.依靠，信任，信赖
dependent	a.依赖(他人)的，依靠的
depict	vt.描画，描绘；描写，描述
deploy	vt.部署，调动
deposit	vt.存放；使沉积
depressed	a.精神抑郁的，情绪沮丧的
depression	n.不景气，萧条(期)
depth	n.深度；深处［常pl.］；深奥，深刻
deputy	n.副职，副手
derive	vi.来(自)，起源(于) vt.得到
descend	vi.传下，遗传；下来，下降
describe	v.描述，形容，刻划，显示
description	n.描写，形容；种类
desert	v.抛弃，遗弃
deserve	vt.值得
design	vt./vi.设计；预定，指定 n.设计；图案
designer	n.设计者
desire	n.愿望
desk	n.书桌
desperate	a.绝望的；没希望的；孤注一掷的
desperately	ad.绝望地；拼命地
despite	prep.不管，尽管
dessert	n.(正餐后的)甜点心
destination	n.目的地，终点
destroy	vt.破坏，毁灭；消灭
destruction	n.破坏，毁灭，消灭
detail	n.细节，详情 vt.详述，详细说明
detailed	a.详细的，详尽的；极注意细节的；完全的
detect	vt.察觉，发现
detective	n.侦探
determination	n.决心，决定
determine	vt.确定
devastating	a.毁灭性的；破坏性极大的
develop	v.发展，进展；发扬，开发
developer	n.(房地产)开发商；开发者
developing	a.发展中的
development	n.发展，进展，发达
developmental	a.发展的，开发的；促使成长的
device	n.策略；手段；装置，设备
devil	n.魔鬼，恶魔
devote	v.奉献，献身，致力
diabetes	n.糖尿病
diagnose	vt./vi.诊断(疾病)；判断
diagnosis	n.诊断
dialogue	n.对话，对白
diamond	n.钻石，金刚石
diary	n.日记
dictate	n.命令，指令 v.口授，口述，使听写
die	vi.死亡
diet	n.通常所吃的食物；(因医疗等)限食的食物
differ	vi.不一致，不同
difference	n.差别
different	a.差异的，不同的
differently	adv.不同地
difficult	a.困难的
difficulty	n.困难
dig	v.挖，掘
digital	a.手指的，指状的；数字的，计数的
dignity	n.尊严
dilemma	n.(进退两难的)窘境，困境
dimension	n.特点，特性
diminish	vi.变少，变小，降低vt.减少，减小，降低
dining	n.就餐
dinner	n.正餐，宴会
dip	DIP 文件图像处理 , vt.&amp;vi.浸，泡，蘸 n.浸泡，蘸
diplomat	a.外交家；外交官
diplomatic	a.外交上的
direct	a.&amp;v.直率的；径直，直接；指导，指引
direction	n.方向，方位
directly	adv.直接地
director	Director 多媒体创作软件 , n.导演
dirt	n.污垢
dirty	a.肮脏的
disability	n.伤残
disabled	a.伤残的；使失去战斗力的
disagree	vi.(with)有分歧，不同意；不一致，不符
disappear	vi.消失
disappointed	a.失望的
disappointment	n.失望
disaster	n.灾难，大祸
disc	n.唱片；录像圆盘
discipline	n.纪律, 学科
disclose	vt.使显露；揭露，泄露
discount	vt.打折扣 n.折扣
discourage	vt.使泄气，使沮丧；阻拦
discourse	n.论文，演说；谈话；话语vi.讲述，著述
discover	v.发现
discovery	n.发现
discrimination	n.歧视
discuss	vt.讨论
discussion	n.讨论，商议
disease	n.疾病
dish	n.碟，盘子；菜肴
disk	磁盘
dismiss	vt.驳回，对…不予受理
disorder	n.混乱；失调，紊乱 vt.使混乱；使失调
display	vt.展示
dispute	vt.对......提出质疑
dissolve	vt.(使)溶解，(使)融化；解散，取消
distance	n.距离，路程
distant	a.在远处的，远隔的，久远的
distinct	a.与其他不同的，独特的；明显的
distinction	n.声誉；荣誉
distinctive	a.特殊的；与众不同的
distinguish	vt.使出众；辨别；区分
distract	vt.转移(注意力)；使转移注意力
distribute	vt.分发；分送
distribution	n.分发；分送
district	n.区，行政区；地区，区域
disturb	vt.使烦恼
disturbing	a.令人不安的；令人烦恼的
diverse	a.不一样的，相异的
diversity	n.差异, 多样性
divide	vt.划分；分开
divine	a.神的；神圣的
division	n.分开，分割；除(法)；部门，科，处
divorce	n./vi.离婚 vt.与…离婚，使分裂
DNA	脱氧脱糖核酸
do	vi./vt.做 v.aux.助动词
dock	n.码头；被告席vt.使(船)进港；扣vi.进港
doctor	n.医生，大夫
doctrine	n.教义，主义；学说
document	vt.用文件证明
documentary	n.记录片
dog	n.狗
doll	n.玩具娃娃
domain	n.(活动等)领域，范围；领地，势力范围
domestic	adj.家庭的，家务的；国内的n.家仆，佣人
dominant	a.占优势的；支配的
dominate	vt.统治，支配，占优势
donate	v.捐赠；赠送
donation	n.捐献；赠送
donor	n.捐献者；赠送人；（组织、器官等的）供体
door	n.门
doorway	n.门口；门道
dose	n.(一次)剂量
dot	vt.散布于，布满，点缀
double	a.&amp;v.两倍的；加倍
doubt	n.&amp;v.怀疑，疑问，疑惑
dough	n.生面团；钱，现款
down	adv.向下
downtown	adj.市中心区的
dozen	n.(一)打
draft	n.草稿, 草案, 草图
drag	vt.拖，拉
drain	vt.排(水等)
drama	n.戏剧
dramatic	a.戏剧性的；引人注目的，给人深刻印象的
dramatically	ad.显著地
draw	vt./vi.画；绘制
drawer	n.抽屉
drawing	n.绘图，图画
dream	n.&amp;v.梦，梦想，幻想；做梦
dress	n.女服
dried	adj.晒干的，晾干的
drift	n.漂流；趋势，倾向 vi./vt.(使)漂流；漂泊
drill	n.钻头，钻床；操练，演习 v.钻(孔)；操练
drink	v.喝
drive	v.驾驶
driver	n.司机
driveway	n.(通往住宅的)车道
driving	驾驶
drop	vt.放弃；革除
drown	vt.淹没；使(某人)淹死
drug	n.麻药，麻醉药
drum	n.边，边缘，刀口，利刃，（灾难的）边缘 v.(使)渐渐移动，略为增减
dry	n.容易，轻易，不费劲，舒适安逸自在无忧无虑 v.(使)宽慰减轻缓解，(使)缓缓移动，(使)容易些
duck	vt.猛按…入水, 躲避
due	a.预期的；约定的；到期的
dumb	a.哑的；不会说话的；笨的；愚蠢的
dump	vt.倾倒
during	prep.在…期间
dust	v.灰尘，尘土
Dutch	n.边，边缘，刀口，利刃，（灾难的）边缘 v.(使)渐渐移动，略为增减，加减边数
duty	n.义务
dying	a.垂死的,临终的
dynamic	a.动力的，动态的；有生气的，有力的
dynamics	n.力学；动力学；原动力学；动态
each	adj./pron.各自(的)；每(个)
eager	a.热切的，渴望的
ear	n.耳朵
early	a.&amp;ad.早，早日的，及早的
earn	v.挣得
earnings	n.所挣的钱
earth	n. 世界，地球，陆地，地面，土，泥土 v.把电线接地
earthquake	n.地震
ease	n.容易，轻易，不费劲，舒适安逸自在无忧无虑 v.(使)宽慰减轻缓解，(使)缓缓移动，(使)容易些
easily	v.(尤指在不合适的地方)丢弃，扔掉，倾倒，丢下，抛弃 n.垃圾场垃圾堆，脏的地方，令人厌恶的地方
east	n.&amp;a.&amp;ad.东，东方，在东方
eastern	a.东方的，东部的；向东方的，来自东方的
easy	a.哑的，不能说话的，不肯开口的，愚笨的 v.(使)沉默
ecological	a.生态的
economic	adj.经济的；经济学的
economically	ad.节约地，在经济上
economics	n.经济学；经济
economist	economy	n.经济
ecosystem	n.［生］生态系统
edge	n.刀口
edit	vt.编辑
edition	n.版，版本
editor	n.编辑
educate	vt.教育
education	educational	a.教育的；有教育意义的
educator	n.教育家
effect	n.效果，作用，影响
effective	a.有效果的，有成效的
effectively	ad.有效(果)地，有成效地
effectiveness	n.效果，有效性
efficiency	n.效率
efficient	a.效率高的
effort	n.努力，尽力
egg	n.鸡蛋
ego	n.自我，自己
eight	num.八
eighth	num.第八
either	pron.两者之一
elaborate	a.精心制作的；复杂的
elbow	n.肘部
elder	n.年长者
elderly	a.较老的，人过中年的 n.近老年人
elect	v.选举
election	n.选举
electric	a.电的，带电的，电动的
electrical	a.电的，电气的
electricity	n.电流
electronic	a.电子的
electronics	n.电子技术；电子学
elegant	a.文雅的，雅致的
element	n.成分，要素；元素
elementary	a.初等的，初级的
elephant	n.(动物)象
elevator	n.电梯，升降机
eleven	num.十一
eligible	a.符合推选条件的；合格的
eliminate	vt.排除，消灭
elite	n.精英，杰出人物 a.杰出的，精英的
else	adv.此外；别的
elsewhere	ad.在别处；向别处
e-mail	e-mail 电子邮件 , 电子邮件
embarrassed	a.尴尬的
embrace	v.拥抱，怀抱 n.拥抱，怀抱
emerge	vi.出现，涌现
emergency	n.紧急情况；急症
emission	n.散发，发射
emotion	n.情感，情绪，感情
emotional	a.感情的，情绪的
emotionally	ad.感情上
emphasis	n.强调, 重点
emphasize	vt.强调，着重
empire	n.帝国
employ	n.&amp;vt.雇佣
employee	n.雇员，雇工
employer	n.雇佣者，雇主
employment	n.雇用；使用；工作，职业
empty	a.空的，空洞的
enable	vt.使(某人)能(做某事)
enact	v.制定(法律等)，通过(法案等)
encounter	v.遭遇(困难、危险)；偶遇，邂逅
encourage	vt.鼓励
encouraging	a.鼓舞人心的
end	n.&amp;v.端，尖，尾；终止，结束
endless	a.无止境的，没完没了的
endorse	v.赞同，支持
endure	vt.忍受，忍耐
enemy	n.敌人
energy	n.能量
enforce	vt.实施，执行；强制
enforcement	n.putting into force 实施, 执行
engage	vi.(in)从事于，参加 vt.使从事于，使忙于
engagement	n.订婚，婚约；约会
engine	n.发动机，引擎；机车
engineer	n.工程师
engineering	n.工程师行业，工程学
English	english n. 英语；adj. 英语的 , n.英语 a.英国人的
enhance	vt.提高，增加
enjoy	vt.享受
enormous	a.巨大的，庞大的
enough	a.&amp;n.&amp;ad.足够，充足
enroll	v.注册，登记
ensure	vt.保证, 担保, 使安全, 保证得到
enter	v.走进，进入
enterprise	n.事业；企业
entertainment	n.娱乐
enthusiasm	n.热情，热心
entire	a.全部的
entirely	ad.全部地，完整地；完全地，彻底地
entitle	vt.给…以权利
entity	n.存在，实体；统一性
entrance	n.入口处
entrepreneur	n.[法]企业家, 创业者
entry	n.进入；入口；登记，条目，账目
envelope	n.信封
environment	n.环境
environmental	a.环境的
envision	v.想象;展望
epidemic	n.&amp;a.流行病(的)
episode	n.（一连串事件中的）一个事件；插曲
equal	a.相等的
equality	n.平等
equally	ad.相等地，平等地；同样地
equation	n.方程式
equip	vt.装备，配备
equipment	n.设备；装备
equity	n.公平；公正
equivalent	n.对等物；对应词
era	n.时代，纪元
error	n.错误，过失
escape	n.&amp;v.逃跑；逃避
especially	ad.特别；尤其
essay	n.散文，随笔
essence	n.本质，实质；要素
essential	a.必需的
essentially	ad.本质上地，实质上地
establish	vt.确立，证实
establishment	n.建立，创办；机构
estate	n.财产；(尤指)遗产
estimate	n.估计，估价；评价 vt.估计，估价
estimated	a.估计的
etc	#NAME?
ethical	morally good
ethics	n.伦理学；伦理观，道德标准
ethnic	a.种族的
European	european adj. 欧洲的；n. 欧洲人 , a.欧洲的 n.欧洲人
evaluate	vt.估价，评价
evaluation	n.估价
even	adv.更加；甚至
evening	n.傍晚，晚上
event	n.事件，事变，大事
eventually	ad.终于，最终
ever	adv.曾经；究竟；在任何时候
every	a.每一个
everybody	pron.每一人
everyday	a.每一天
everyone	pron.每人
everything	pron.每一件事
everywhere	ad.各处
evidence	n.根据，证据
evident	a.明显的，明白的
evil	a.坏的，邪恶的
evolution	n.进化
evolve	v.进化;演化
exact	a.精确的，正确的
exactly	ad.确切地；精确地
exam	n.考试；检查
examination	n.=exam考试，测验
examine	v.检查
example	n.例，实例；范例，榜样
exceed	vt.超过
excellent	a.优秀的
except	prep.除…之外
exception	n.除外，例外
excessive	a.过多的，过分的
exchange	vt./n.交换，调换；交流
excited	a.激动的，兴奋的
excitement	n.刺激，兴奋，激动
exciting	a.令人兴奋的
exclude	v.阻止...进入；把...排除在外
exclusive	a.不算；不包括；把...排斥在外
exclusively	ad.排斥其他地；单独地；专有地
excuse	excuse vt.原谅 , 原谅
execute	vt.实行，执行，完成，贯彻；将…处死
execution	n.实行；执行，履行
executive	a.&amp;n.实行的，执行的；执行者
exercise	n.&amp;v.练习
exhaust	vt.使精疲力尽；耗尽n.排气装置；废气
exhibit	vt.展出,显示
exhibition	n.展览会
exist	vi.存在
existence	n.存在，实有
existing	a.现存的，目前的
exit	n.出口(处)
exotic	a.外国的；异国情调的
expand	vt./vi.扩大，膨胀，扩张
expansion	n.扩张，扩充；扩大；扩充物；扩展部
expect	v.期待，盼望
expectation	n.期待，期望
expected	adj．预期的，预料的
expedition	n.远征；远征(探险，考察)队；迅速
expense	n.花费
expensive	a.高价的，昂贵的
experience	n.经验
experienced	a.有经验的
experiment	n.试验，实验 v.做实验，进行试验
experimental	a.实验的；经验的
expert	n.专家，能手
expertise	n.专门知识(技能等)；专家鉴定，评价
explain	v.解释
explanation	n.解释
explicit	a.明确的；直爽的
explode	vt.使爆炸 vi.爆炸；突发
exploit	vt.利用；开发
exploration	n.考察；勘探；探查
explore	vt.勘探; 探索; 探查
explosion	n.爆炸，爆发
export	vt.输出，出口 n.输出品，输出，出口
expose	vt.揭露；暴露
exposure	n.暴露，揭露；曝光
express	a.急速的；特殊的
expression	n.表示，表现；措辞，语句；表情，脸色
extend	vt.使延长；使延期；扩展，扩大
extended	a.展开的；延伸的，延续的；广泛的
extension	n.伸张，伸展，扩大；电话分机
extensive	a.巨大的；严重的；广阔的；广大的
extent	程度，范围
external	a.外在的，在外的
extra	a.额外的，外加的
extraordinary	a.非同寻常的，特别的
extreme	n.极端
extremely	ad.极端，非常
eye	n.眼睛
eyebrow	n.眉毛，眉
fabric	n.结构，组织；织物，（纺）织品
face	n.&amp;v.脸，面，表面；面临，面向
facilitate	vt.使便利
facility	n.［常pl.］设备，设施；便利，容易
fact	n.事实，实际，真相
factor	n.因素，要素
factory	n.工厂，制造厂
faculty	n.能力
fade	vi.消失; 褪色; 衰弱
fail	v.失败
failure	n.失败者
faint	vi.晕倒
fair	a.公平的
fairly	ad.相当地
faith	n.信任；信仰
fall	n.&amp;v.落下，跌落，降落
fame	n.名望，名声
familiar	a.熟悉的
family	n.家庭
famous	a.著名的
fan	n.(运动、电影等的)狂热爱好者，迷
fantastic	a.异想天开的，不现实的；难以相信的
fantasy	n.想像，幻想
far	a.&amp;ad.远，遥远，久远
fare	n.食物
farm	n.&amp;v.农场，农庄，牧场；耕作，经营农场
farmer	n.农夫，农场主
fascinating	a.迷人的，吸引人的
fashion	n.时髦;姿态
fast	ad.快
faster	更快
fat	fat a.肥胖的；厚的，丰满的 n.脂肪，肥肉 , (file allocation table)文件分配表
fatal	a.致命的，毁灭性的
fate	n.命运
father	n.父亲
fatigue	n.疲劳，(金属材料等的)疲劳
fault	n.缺点，毛病；错误，过失；［地］断层
favor	n.好感，喜爱
favorable	a.赞成的，赞许的
favorite	n.&amp;a.最喜爱的人(或物)；最喜爱的
fear	n.&amp;v.恐惧，害怕，担心；恐怕
feather	n.羽毛，翎毛
feature	n.an important part or quality 特征
federal	adj.联邦的
fee	n.费用
feed	v.饲养 n.饲料；食物
feedback	n.反馈
feel	v.感觉，感到
feeling	n.感觉，知觉；情感
fellow	n.家伙，小伙子；同辈，同事，伙伴
female	a.雌的，女(性)的 n.女子；雌性动物
feminist	a.主张男女平等的，女权主义的
fence	护栏
festival	n.节日，(定期在某地举行的)音乐、戏剧节等
fever	n.发烧
few	a.很少
fiber	n.纤维
fiction	n.小说
field	n.田野；原野；场地
fierce	a.暴怒的；凶猛的；残酷的；强烈的
fifteen	num.十五
fifth	num.第五
fifty	num.五十
fight	v.打架
fighter	n.战士
fighting	n．战斗；打仗
figure	n.数字；人物；外形vt.(out)演算出；想出
file	vi.排成纵队行进
fill	v.装满
film	n.电影，胶卷
filter	vi.过滤,透过
final	a.最后的，最终的，决定性的
finally	ad.最后；最终
finance	n.财政，金融；经费，资金
financial	a.财政的；金融的
find	vt.找到；发现
finding	n.发现(物)；［常pl.］(调查或研究)结果
fine	a.美好的
finger	n.手指，指头
finish	v.&amp;n.完毕，结束，完成
fire	vt.解雇
firm	a.稳固的 n.公司
firmly	ad.强有力地；牢牢地
first	a./ad.第一
fiscal	a.国库的，(政府)财政的
fish	n.鱼
fisherman	n.渔夫
fishing	n.捕鱼，钓鱼
fist	n.拳头
fit	v.适合
fitness	n.健康
five	num.五
fix	n.an injection of narcotics 毒品注射剂
fixed	固定的
flag	vi.衰退
flame	n.火焰
flash	n.(火焰等)一闪,闪亮
flat	a.平坦的，扁平的
flavor	n.味，味道；风味，特色 vt.给…调味
flee	vi./vt.(fled,fled)逃离；逃避
fleet	n.舰队；船队
flesh	n.肉，肉体
flexibility	n.flexible quality 灵活性，柔韧性
flexible	a.柔韧的，柔顺的；可变通的，灵活的
flight	n.飞行，飞翔；航班，班机；逃跑，溃退
flip	v.掷，弹
float	vi./vt.(使)漂浮
flood	n.洪水 v.淹没
floor	n.楼层；地板；室内地面
flour	n.面粉,粉
flow	vi.(潮)涨；上升；流
flower	n.花，花卉
fluid	n.液体
fly	vi.飞翔
flying	a.(谣言等)到处流传的
focus	vt./vi.(使)聚焦，(使)集中 n.焦点，中心
fog	n.雾
fold	vt.折叠
folk	n.人们；［口］家属，亲属 a.民间的
follow	v.跟随，追逐，追求；听从
following	a.接着的；下列的
food	n.食物
fool	n.笨蛋，傻瓜
foot	n.([复数]feet)脚
football	n.橄榄球(运动)
for	prep.为
forbid	vt.禁止
force	n.力量
forehead	n.前额
foreign	a.外国的
foreigner	n.外国人
forest	n.森林
forever	ad.永远
forget	vt.忘记
forgive	vt.原谅
fork	n.叉
form	v.建立
formal	a.正式的；形式的；礼仪上的
format	n.格式，样式
formation	n.形成(物)
former	a.在前的，以前的 n.前者
formerly	ad.以前，从前
formula	n.(formulas或formulae)公式
forth	ad.向前，向外
fortunately	ad.幸运地，幸亏
fortune	n.财富；运气
forty	num.四十
forum	n.论坛
forward	a.早的；迅速的
foster	Foster 福斯特(姓或名) , vt ．养育收养怀抱鼓励a ．收养的n ．养育者
found	vt.建立
foundation	n.基础
founder	founder n.奠基者，创建者，缔造者 , n．方正公司
four	num.四
fourth	num.第四
fraction	n.(某物的)小部分，一点儿 n.分数；小数
fragile	a.易碎的，脆的，易损坏的；虚弱的，脆弱的
fragment	vt.使成碎片，使分裂
frame	n.构架，框架
framework	n.框架，构架，结构
franchise	n.特权，特权；专营权，特许权
frankly	ad.直率地; 慷慨地
fraud	n.欺骗(行为)；骗局，诡计
free	adj.空闲的；自由的
freedom	n.自由，自主
freely	ad.自愿地
freeze	vt.结冰；冷冻
French	french n. 法语 , a.法国的 n.法国人
frequency	n.频率
frequent	a.频繁的
frequently	ad.频繁地
fresh	a.新鲜的
freshman	n.大(中)学一年级学生
friend	friend n.朋友 , n.朋友
friendly	a.友谊的，友好的
friendship	n.友谊
from	prep.从；来自…
front	n./adj.前面(的)
frontier	n.边境，边界；边疆；边远地区
frown	vi.皱眉(表示不满)
frozen	a.固定不变的；冻住的
fruit	n.水果
frustrate	vt.挫败；阻挠…的成功；使受挫折
frustration	n.挫败，挫折
fuel	n.燃料
full	a.满的，充满的
full-time	a.专任的
fully	ad.完全地，全部地，彻底地；充分地
fun	n.乐趣；有趣的人(或事物)
function	n.操作
functional	a.功能的；职务上的；实用的
fund	n.基金，专款；储备，贮存 vt.提供资金
fundamental	a.基本的，根本的 n.基本原则，基本原理
funeral	n.葬礼
funny	a.滑稽的，可笑的，有趣的
fur	n.软毛；毛皮；毛皮衣物
furniture	n.家具；设备
furthermore	ad.而且；此外
future	n.未来
gain	v.&amp;n.增加
galaxy	n.星系
gallery	n.画廊，美术馆；长廊；走廊
game	n.游戏，玩耍；比赛
gang	n.一队，一族；一群，一帮
gap	n.豁口；缺口；峡谷；山口；差距；分歧
garage	n.汽车库
garbage	n.废料；垃圾；废物
garden	n.花园
garlic	n.大蒜
gas	n.气体；煤气；汽油
gasoline	n.汽油
gate	n.大门；门
gather	v.聚集，集合；采集，收集
gathering	n.聚集；集会
gay	n.愉快；快乐
gaze	vi./n.凝视，注视
gear	vt.调整；用齿轮连结 n.齿轮；排挡
gender	n.性别
gene	n.基因
general	a.普通的
generally	ad.一般地，通常，大体上
generate	vt.发生；产生
generation	n.(一)代
generous	a.慷慨的，大方的
genetic	a.遗传（学）的
genius	n.天才
genre	n.(文学、艺术等的)类型，体裁，风格
gentle	a.温和的
gentleman	n.绅士，先生
gently	ad.轻轻地
genuine	a.真正的，名副其实的；真诚的，坦率的
German	german adj. 德国的；n. 德国人 , adj.德国的 n.德国人
gesture	n.姿势，手势
get	vt./vi.得到；获得
ghost	n.鬼魂
giant	n.巨人；巨物，巨大的动物 a.巨大的
gift	n.礼物
gifted	a.有天才的, 有才华的
girl	n.女孩
girlfriend	n.女朋友
give	vi.弯曲；塌下
given	a.specified, fixed 特定的,一定的
glad	adj.高兴的；乐意的
glance	v.&amp;n.看一眼；一看，一瞥
glass	n.玻璃，玻璃杯；镜子，眼镜(pl.)
glimpse	n.a quick view or look 一瞥，一看
global	a.球形的，球面的；世界的；普遍的
globe	n.球；球状物；天体
glory	n.光荣，荣誉；荣誉的事
glove	n.手套
go	vi.去
goal	n.终点，球门；目标，目的
goat	n.山羊
God	God n.上帝，神 , n.上帝；造物主；偶像
gold	n.黄金
golden	a.金色的
golf	n.高尔夫球
good	adj.好；令人满意的
govern	vt.[常被动]决定；统治；治理；支配；影响
government	n.政府
governor	n.统治者，管辖者；地方长官
grab	vt.抢夺，攫取
grace	n.优美的
grade	n.&amp;v.等级，年级；分数；分等，分级
gradually	ad.逐渐地
graduate	n.毕业生v.毕业
graduation	n.毕业
grain	n.谷物
grand	a.dignified,stately (外)祖…；(外)孙
grandchild	n.孙子，孙女；外孙，外孙女
grandfather	n.祖父；外祖父
grandmother	n.祖母，外祖母
grandparent	n.祖父或祖母，外祖父或外祖母
grant	vt.同意；准予 n.同意，授予；拨款
grape	n．葡萄
grasp	v.理解；领会
grass	n.草，牧草
grateful	a.感激的；感谢的
grave	a.严重的；严肃的
gravity	n.严肃，认真；重要性；［物］重力
gray	Gray 格雷(男子名) , a.灰色的n.灰色
great	a.伟大的
greatest	是great的最高级
greatly	adv.极大地
Greek	a.希腊的；希腊人(语)的 n.希腊语(人)
green	green a.绿，幼稚的 n.绿色 , n.(姓)
greet	v.问候
grief	n.悲哀
grin	n.露齿的笑 vi.露齿而笑
grip	vt./n.紧握，紧夹；掌握，控制
grocery	n.食品杂货店
gross	a.总的；毛的
ground	n.地面；战场
group	n.群，小组
grow	vt./vi.种植；生长
growing	adj．发展的，扩大的
growth	n.增长，增加；生长，发展
guarantee	n./vt.保证，担保，保修
guard	v.守卫
guess	v.&amp;n.推测，猜测
guest	n.客人
guidance	n.引导，指导
guide	n.向导 v.指导
guideline	n.指导方针，指导原则，准则，标准
guilt	n.有罪；内疚
guilty	a.有罪的；内疚的
guitar	n.六弦琴，吉他
gun	n.枪
gut	a.本能的，发自内心深处的
guy	guy n.家伙，人；牵索 , (男人名)
gym	n.[口]体育馆，健身房
ha	Ha int.哈！(表示惊异，愉快，怀疑，胜利等) , int.哈(表示惊讶、欢乐、胜利、愠怒等)
habit	n.习惯
habitat	n.产地；栖息地
hair	n.毛发，头发，汗毛
half	n.一半
halfway	a.中途的，不彻底的 ad.至半途，中途地
hall	n.礼堂
hallway	n.门厅；过道
hand	vt.交；递
handful	n.一把，一小撮
handle	n.柄，把手 vt.运用，操纵；经营，管理
handsome	a.英俊的；大方的
hang	n.吊，悬挂；吊死，绞死
happen	v.发生
happily	adv.幸福地；愉快地
happiness	n.快乐；幸福
happy	a.幸福的
harassment	n.骚扰
hard	adv.努力地 adj.困难的
hardly	ad.几乎不
hardware	n.金属器具
harm	n.伤害 vt.伤害，损害
harmony	n.协调，和谐；融洽，一致
harsh	a.粗糙的；(声音)刺耳的；严厉的，苛刻的
harvest	n.&amp;v.收获
hat	n.帽子
hate	v.&amp;n.恨，憎恨，讨厌
haul	vt.拖曳
have	v.有
hay	n.干草
hazard	n.危险
he	pron.他
head	n.&amp;v.头，头顶；头脑；率领，领导
headache	n.头痛
headline	n.大字标题；新闻提要
headquarters	n.司令部
heal	v.治愈，愈合，痊愈
health	n.健康，卫生
health-care	n.卫生保健
healthy	a.健康的
hear	vt.听说
hearing	n.倾听；听证
heart	n.心，心脏；中心，要点；内心，心肠
heat	n.热 vt.加热
heaven	heaven n.天堂，天国，上帝；天，天空 , n.上帝，神
heavily	ad.大量地
heavy	a.重的
heel	n.脚跟，鞋跟
height	n.高度
helicopter	n.直升飞机
hell	n.地狱，阴间；用以咒骂或表示愤怒，不满
hello	int.喂
helmet	n.头盔
help	Help 帮助 , 帮助
helpful	adj.乐于助人的；有帮助的
hence	ad.因此，由此
her	pron.她的
herb	n.药草，(调味用的)香草，草本植物
here	adv./n.这里
heritage	n.传统；遗产；继承物
hero	n.英雄
hers	pron.她的
herself	pron.她自己
hesitate	vi.犹豫，迟疑不决
hey	int.嗨!
hi	interj.嗨
hidden	hide的过去分词
hide	n.兽皮
high	high a.&amp;ad.高，高度的，高级的，高尚的 , 中学；高中 (=High School)
highlight	vt.强调，使显著
highly	ad.高度地；极；非常
high-tech	a.高技术的
highway	n.a main public road 公路；大路
hike	n.徒步旅行；增加vi.徒步旅行vt.提高
hill	n.山
him	pron.他
himself	himself pron.他自己 , n．上帝
hint	n.暗示，迹象
hip	n ．臀部，骸；屋脊
hire	v.租
his	pron.他的
Hispanic	a.拉丁美洲的
historian	n.历史学家
historic	a.历史上著名的，具有历史意义的
historical	a.历史的，历史上的
historically	ad.历史地；与历史有关
history	History 历史课 , n.历史,历史学;来历,经历
hit	v.&amp;n.打击，击中，碰撞
hockey	n.曲棍球；冰上曲棍球，冰球
hold	v.保持
hole	n.洞
holiday	n.假日，假期，休假
holy	a.神圣的，上帝的，宗教的
home	adv.回家；在家 n.家
homeland	n.祖国
homeless	adj.无家可归的
homework	n.家庭作业
honest	a.诚实的，老实的，正直的
honestly	ad.诚实地；正直地；的确，实在
honey	n.宝贝，心肝(亲爱者之间的昵称)；蜂蜜
honor	n.&amp;v.荣誉，光荣，敬意，尊敬
hook	n.钩，钩状物
hope	vt.,vi./n.希望；期望
hopefully	ad.in a hopeful manner 怀着希望；但愿
horizon	n.地平线；(喻)眼界，见识
hormone	n.激素，荷尔蒙
horn	n.（牛、羊、鹿等动物的）角
horrible	a.可怕的，恐怖的；讨厌的
horror	a.(电影等)意在引起恐怖的 n.恐惧；震惊
horse	n.马
hospital	n.医院
host	n.主人
hostage	n.人质
hostile	a.敌对的；不友善的，敌意的
hot	adj.热的
hotel	n.旅馆
hour	n.小时；钟点，时刻；课时
house	house 房屋 , 院
household	n.一家人，家族 a.普通的，平常的
housing	n.房屋；住宅
how	ad.如何
however	ad.无论如何
hug	n.&amp;vt.(紧紧)拥抱
huge	a.巨大的，庞大的
huh	int.哼! 哈!
human	n.人类
humanity	n.人性；仁慈；人类
humor	n.幽默
hundred	num.百
hunger	vi..饥饿, 欲望, 渴望
hungry	a.饥饿的
hunt	v.&amp;n.打猎，狩猎；寻找，搜索
hunter	hunter n.猎人 , (姓)亨特
hunting	n.搜寻
hurricane	n.飓风；暴风雨
hurry	v.&amp;n.赶忙，匆忙，慌忙
hurt	v.刺痛
husband	n.丈夫
hypothesis	n.假设；前提
I	I pron.我 , pron. 我
ice	n.冰
icon	n.偶像；崇拜的对象；画像
idea	n.想法，念头；概念，观念
ideal	a.理想的，完美的 n.理想
identical	a.同一的；完全相同的
identification	n.鉴别
identify	vt.鉴别，识别
identity	n.身份
ideological	a.思想的
ideology	n.思想（体系）
if	conj.如果
ignore	vt.不理，忽视
ill	a.有病的
illegal	a.against the law 不合法的，非法的
illness	n.疾病；生病
illusion	n.错觉；幻觉
illustrate	vt.说明，阐明；给…作插图说明
image	n.雕像
imagination	n.想像力
imagine	vt.设想；想象
immediate	a.立即的，即刻的；直接的，最接近的
immediately	ad.立即地，即刻地；直接地，紧密地
immigrant	n.移民，侨民
immigration	n.移居；外来的移民
immune	a.免疫的，有免疫力的；不受影响的
impact	n.冲击，碰撞；影响 vt.装紧，压紧
implement	vt.实现；完成；履行
implementation	n.实施，贯彻
implication	n.含义
imply	vt.暗示，意味
import	v.&amp;n.进口
importance	n.重要(性)
important	adj.重要的
impose	v.加（负担、惩罚等）于
impossible	a.不可能的，做不到的
impress	vt.给…深刻的印象，使铭记
impression	n.印象；印记，压痕
impressive	a.给人印象深刻的，感人的
improve	v.改善，改进；好转，进步
improvement	n.改进，改善；改进处
impulse	n.(一时的)冲动，冲力；脉冲；神经冲动
in	prep.在…里
incentive	n.刺激
incident	n.事件
include	v.包含，包括，计入
including	prep.包括，包含
income	n.收入
incorporate	vt.包含，合并；体现
increase	v.&amp;n.增加
increasing	递增
increasingly	ad.日益，愈加
incredible	a.难以置信的
incredibly	adv.难以置信地
indeed	ad.的确，确实
independence	n.独立，自立
independent	a.独立的,不受约束的
index	n.指数，指标
Indian	Indian 印第安人 , a.印度(人)的,印第安人的 n.印度(安)人
indicate	vt.显示，象征，指出
indication	n.迹象
indicator	指示符
indigenous	a.土生土长的，本土的
individual	a.个别的，单独的n.个人，个体
industrial	a.工业的，产业的
industry	n.工业，产业
inevitable	a.不可避免的，必然(发生)的
inevitably	ad.不可避免地，必然地
infant	n.婴儿，幼儿 a.婴儿的，幼儿的
infection	n.感染；传染
inflation	n.通货膨胀
influence	vt.影响
influential	a.有影响的；有权势的
inform	vt.告知
informal	a.非正式的
information	n.情报，信息
infrastructure	n.基础；基础结构
ingredient	n.(混合物的)成分
inherent	a.内在的，生来的
inherit	vt.继承(金钱等)，经遗传而得(性格、特征)
initial	a.最初的，开始的；词首的 n.首字母
initially	ad.最初，开始
initiate	v.创始；发起；开始实施
initiative	n.主动的行动；主动
injure	vt.伤害
injury	n.损害，伤害；受伤处
inmate	n.囚徒；被收容者；住院者
inner	a.内部的，里面的；思想的 n.内部；里面
innocent	a.无罪的，无辜的；天真无邪的；无害的
innovation	n.革新；新方法
innovative	a.创新的，革新（主义）的
input	n.输入(物、数据)；投入
inquiry	n.询问
insect	n.虫，昆虫
insert	n.插页
inside	adv.,prep.,adj./n.在里面；在…里面
insight	n.洞察力
insist	v.坚持，坚持主张，强烈
inspection	n.检查
inspector	n.检查员，视察员；(警队)督察
inspiration	n.灵感
inspire	vt.激发，使产生灵感
install	vt.安装
installation	n.安装，设置；装置，设备
instance	n.例，例证，实例
instant	n.即刻，即时
instantly	ad.立即，马上
instead	ad.代替；更换
instinct	n.本能，直觉；生性，天性
institution	n.公共机构
institutional	a.惯例的，制度上的
instruct	vt.教导，指示
instruction	n.教学，指导；命令，指示，用法说明
instructor	n.（美）大学讲师
instrument	n.仪器；乐器
insurance	n.保险
intact	a.完整无损的
integrate	v.使结合，使成一体
integrated	a.成整体的，完全的，完整的
integration	n.综合
integrity	n.诚实，正直；完整
intellectual	a.智力的
intelligence	n.智力
intelligent	a.聪明的；明智的
intend	v.想要，打算，企图
intense	a.强烈的
intensity	n.强烈，剧烈
intent	n.意图，目的
intention	n.目的，意图
interact	vi.相互作用
interaction	n.相互作用；干扰
interest	n.&amp;v.兴趣，关心，注意；使发生兴趣
interested	adj.感兴趣的
interesting	a.有趣的，引人入胜的
interfere	vi.干涉，介入；妨碍，干扰
interior	n.内部
internal	a.内部的；体内的
international	a.国际的, 世界的
Internet	internet n.因特网，国际互联网络 , 网际
interpret	vi.解释，说明
interpretation	n.解释
interrupt	vt.打断，打扰；阻碍 vi.打断，打扰
interval	n.间隔，间距；幕间(或工间)休息
intervention	n.干预
interview	n.面试；接见；会见
intimate	a.亲密的
into	prep.到…里
introduce	v.介绍
introduction	n.引言;导论
invade	vt.侵犯
invasion	n.侵入；侵略；侵犯
invent	vt.发明
invention	n.发明，创造；捏造，虚构
inventory	n.详细目录，清单
invest	v.投资
investigate	v.调查，调查研究
investigation	n.调查
investigator	n.调查者
investment	n.投资
investor	n.投资者
invisible	a.看不见的
invitation	n.邀请
invite	v.邀请，招待
involve	vt.(必须)包括
involved	a.有关的
involvement	n.卷入，牵连；牵连到的事，复杂情况
Iraqi	n.伊拉克人 a.伊拉克的
Irish	a.爱尔兰(人)的
iron	n.铁 v.烫平
ironically	ad.具有讽刺意味地；嘲讽地，挖苦地
irony	n.反语法；嘲弄
Islam	n.伊斯兰教，回教；伊斯兰教信徒
Islamic	islamic a.伊斯兰教的 , a.伊斯兰教的，伊斯兰的
island	n.岛
isolate	vt.[常被动]使孤立；使脱离；使隔离
isolated	a.孤立的；分离的
isolation	n.隔离；孤立
Israeli	a.以色列的
issue	vt.发行；出版
it	it pron.它 , Information Technology
Italian	Italian a.意大利的 n.意大利人；意大利语 , adj.意大利的
item	n.条，条款，项目
its	pron.它的
itself	itself pron.它自己 , pron.它自己；自身
jacket	n.夹克衫
jail	n.监狱，看守所；监禁 vt.监禁；拘留，禁锢
Japanese	Japanese n.日本人；日语；日文 a.日本的；日本语的 , adj. 日本的；n. 日本人
jar	vt.震动, 刺激
jaw	n.颔，颚
jazz	n.爵士乐
jeans	n.牛仔裤
jet	n.喷射；喷气式飞机
Jew	n.犹太人
jewelry	n.珠宝，首饰
Jewish	Jewish adj.犹太人的 , a.犹太人的
job	Job n.职业,职位;一件工作,活儿 , n.工作；职务
join	join v.加入 , vt.加入
joint	joint a.共同的 , n.接头，接缝；关节
joke	n.笑话；笑料
journal	n.杂志；日报
journalism	n.新闻业；［总称］报刊；新闻学
journalist	n.新闻工作者；记者
journey	n.旅行，旅程
joy	n.欢乐，喜悦
judge	n.法官，审判员
judgment	n.判决；判断；看法，意见，判断力
judicial	a.司法的，法庭的，审判的；公正的
juice	n.汁，液
jump	v.&amp;n.跳跃，跳动
jungle	n.丛林
junior	a.年少的，下级的
jurisdiction	n.司法权，审判权，裁判权
juror	n.陪审员
jury	n.陪审团
just	ad.刚才 a.公正的
justice	n.正义，公正；司法
justify	vt.证明…是正当的；为…辩护
keep	v.保持
key	n.钥匙；关键
kick	n.&amp;v.踢
kid	n.小孩，小伙子
kill	v.杀死，消灭
killer	n．杀人者；凶手 (口)造成灾难的事物
killing	n.杀害，杀人
kind	n.种类
king	n.国王
kingdom	n.王国；领域
kiss	v.&amp;n.亲吻
kit	n.配套元件
kitchen	n.厨房；炊具
knee	n.膝盖
kneel	v.跪下
knife	n.刀
knock	n.&amp;v.敲
know	vi.知道
knowledge	n.知识
known	adj.闻名的；众所周知的
Korean	n. ＆ adj.朝鲜的；朝鲜人的；朝鲜语的
lab	n．实验室
label	n.标签 v.把...称为；用标签于；用标签标明
labor	n.&amp;v.工作，劳动，苦干
laboratory	n.实验室
lack	n./vt.缺乏，不足，没有
ladder	n.梯子
lady	n.(客气称呼)女士
lake	n.湖
lamp	n.灯 vt.照亮
land	n.陆地，土地；国土，国家
landing	n.楼梯过渡的平台
landmark	n.标志性建筑，界标
landscape	n.风景；风景画
lane	n.通道
language	n.语言
lap	n.膝部；(跑道的)一圈
large	a.大的
largely	ad.大量地；主要地
laser	n.激光
last	a.最后的 ad.最后 n.最后
late	a.晚的 ad.晚
lately	ad.最近，不久前
later	ad.后来；以后
Latin	Latin a.拉丁的，拉丁人(语)的 n.拉丁语(人) , a.拉丁的 n.拉丁语
latter	a.后者的；后一半的，接近终了的 n.后者
laugh	v.&amp;n.笑
laughter	n.笑声
launch	vt.发射；使(船)下水 n.发射，(船)下水
laundry	n.洗衣店
law	n.法律
lawmaker	n.立法者
lawn	n.草坪
lawsuit	n.诉讼(案件)
lawyer	n.律师
lay	v.放置
layer	n.层，层次
lead	v.领导 n.领导，领先
leader	n.领袖，领导人
leadership	n.power of leading 领导能力，领导阶层
leading	a.领导的，指引的；最重要的，主要的
leaf	n.叶，叶子
league	League n.共青团 , n ．同盟，联盟；联合会，社团
lean	vi.靠，倚
leap	v./n.(leapt或leaped)跳跃；飞跃
learn	v.学习
learning	n.学习；学问，知识
least	a.&amp;ad.最小的(地)，最少的(地)
leather	n.皮革
leave	v.遗忘；动身
lecture	n.演讲
left	n.&amp;a.左，左面，左边
leg	n.腿
legacy	n.遗产
legal	a.法律(上)的
legally	ad.合法地
legend	n.传说；传奇
legislation	n.立法；法规
legislative	a.立法的；有立法权的
legislator	n.立法者
legislature	n.立法机关
legitimate	a.合法的；合理的
lemon	n.柠檬
lend	v.借给
length	n.长度
lens	n.透镜；眼睛水晶体
less	a.更少(或更小)的，较少(或较小)的
lesson	n.课；功课
let	v.让
letter	n.信；文字
level	v.使平
liability	n.责任，义务；不利条件
liberal	a.开明的
liberty	n.自由，自由权；冒昧，失礼；特许权，特权
library	n.图书馆(室)
license	n.理由，借口；许可证，执照
lid	n.盖，盖子
lie	vi.平放
life	n.生命，寿命，一生；生活
lifestyle	n.生活方式
lifetime	n.一生，终身
lift	n.电梯
light	n.灯光；灯
lighting	n.照明，照明设备
lightly	adv.轻轻地
lightning	n.闪电
like	v.爱好；喜欢
likelihood	n.可能，可能性；有希望的事
likely	a.可能的，有希望的 ad.很可能
likewise	ad.同样地
limb	n.肢，翼
limit	n.限度，限制；［pl.］范围 vt.限制，限定
limitation	n.限制；限度，局限
limited	a.有限的
line	n.行业
link	vt.连接；联系
lion	n.狮子
lip	n.嘴唇
liquid	a.液体的，液态的 n.液体
list	n.目录
listen	v.听
listener	n.听者，收听者
literally	ad.确实地；简直
literary	a.文学(上)的
literature	n.文学，文学作品；文献，图书资料
little	a.小的
live	vi.居住；生活
liver	n.肝；肝脏
living	a.活(着)的
load	vt.装满
loan	n.借出的东西；货款
lobby	n.大厅，门厅，穿堂
local	当地的；地方性的
locate	vt.探明，找出
location	n.地点；位置
lock	n.&amp;v.锁
log	n.原木
logic	n.逻辑(学)；推理(法)
logical	a.逻辑(上)的，符合逻辑的
lonely	a.孤独的
long	long a.长 n.不久 vi.渴望 , (姓)
long-term	a.长期的
look	vi.瞧；看上去
loop	vt.把(绳等)打成环 n.圈，环
loose	adj.松的，散装的
lose	v.丢，丧失；失败，输
loss	n.遗失，丧失；损失，亏损；失败
lost	lose过去式
lot	n.许多
loud	a.高声的
love	vt.爱；热爱
lovely	a.可爱的
lover	n.情人；爱好者
low	a.低，矮；低级的，下层的，卑贱的；低声的
lower	a.&amp;v.较低的，下级的，下游的；放低
loyal	ad.忠诚地，忠实地
loyalty	n.忠诚；忠心
luck	n.运气
lucky	adj.幸运的
lunch	n.午餐
lung	n.肺
machine	n.机器，机械
mad	a.疯；神经错乱
magazine	n.杂志
magic	n.魔法，魔术 a.有魔力的
magnetic	a.磁的，有吸引力的
magnitude	n.重要性，重大；巨大，广大
mail	n.邮件
main	n.主要部分
mainly	ad.主要地，大体上
mainstream	n.(思想或行为的)主流 a.主流的
maintain	vt.维持；维修；供养
maintenance	n.维持，保持；维修；坚持，维护
major	a.主修的；成年的
majority	n.多数，大半；多数党，多数派
make	vt.使；迫使
maker	n.制造者；制造商
makeup	n.性格，气质
male	a.雄的；男(性)的 n.男子；雄性动物
mall	n.购物街
man	n.男人；人
manage	v.处理
management	n.资方；管理(部门)
manager	n.经理
managing	a.经营的，处理的，节约的
mandate	v.托管
manipulate	vt.操纵，控制，影响；(熟练地)使用
manner	n.礼貌
mansion	n.豪宅，大厦
manual	a.手的，用手(操作)的；体力的 n.手册
manufacturer	n.制造商，制造厂
manufacturing	制造
many	a.许多的 pron.许多
map	n.地图
marble	n.弹子；大理石 a.大理石的，大理石般的
march	march v.前进 , n.三月
margin	n.页边的空白
marine	Marine n.(美国)海军陆军战队士兵或军官 , a.海军的
mark	n.&amp;v.标志
marker	n.标记
market	n.市场
marketing	n.营销
marketplace	n.集会场所，市场
marriage	n.结婚，婚姻
married	a.婚姻的；已结婚的
marry	v.结婚，嫁，聚
mask	vt.遮盖；掩盖
mass	n.块；聚集；集中
massive	a.大而重的，魁伟的；大规模的，大量的
master	n.主人，雇主；能手，名家 v.掌握，精通
match	n.&amp;v.比赛，竞赛；婚姻；(和)相配
mate	n.朋友，伙伴，同事
material	n.材料，原料，资料
math	n.数学
mathematics	n.数学
matter	vi.要紧，有关系
maximum	n.最大限度，最大量 a.最高的，最大的
may	may v.mod.可能，也许，可以 , n.五月
maybe	ad.可能
mayor	n.市长
me	ME n.德育=moral education , pron.我[I的宾格]
meal	n.一餐，一顿饭，膳食
mean	v.意指，意味着
meaning	n.意思，意义，含义
meaningful	a.富有意义的
meantime	n.&amp;ad.其间
meanwhile	ad.同时
measure	n.尺寸；方法
measurement	n.测量
meat	n.肉，食用肉类
mechanic	n.机械工；机修工
mechanical	a.技巧上的，细节上的
mechanism	n.机械装置；机制
medal	n.奖章
media	n.新闻媒体
medical	a.医学的；医疗的
medication	n.药物治疗；药物
medicine	n.内服药；医学
medium	n.媒介物，传导体 a.中等的，适中的
meet	n.会，集会
meeting	n.会议
melt	v.(使)融化；(使)熔化
member	n.成员，会员
membership	n.会员地位；全体会员
memory	n.记忆；内存
mental	a.精神的；思想上的
mentally	ad.智力上，脑力上
mention	vt.提及
mentor	n.指导者，良师益友
menu	n.菜单
merchant	n.商人
mere	a.仅仅的，只不过的
merely	ad.仅仅，只不过
merit	n.优点，长处；功绩，功劳
mess	n.混乱，肮脏
message	n.通讯，消息，音信
metal	n.金属
metaphor	n.隐喻
meter	n.米；公尺
method	n.方法
metropolitan	a.大城市的，大都会的
Mexican	n.a.墨西哥人；墨西哥(人)的
middle	a.中间的 n.中间
middle-class	a.中产阶级的
midnight	n.午夜
midst	n.中间，当中 prep.(=amidst)在…当中
might	n.力量
migration	n.迁移，移居；(鸟类等的)迁徙
mild	a.温和的，温柔的；轻微的，不严重的
military	a.军事的
milk	n.牛奶
mill	n.工厂，车间
million	n.&amp;a.百万
mind	n.&amp;v.头脑，精神，理智；介意，留心
mine	pron.我的
mineral	n.矿物，矿石
minimal	a.尽可能少的，最小的
minimize	vt.使减到最少
minimum	n.最小量；最低限度 a.最小的；最低的
minister	n.部长；大臣
ministry	n.(政府的)部；牧师的职务，全体牧师
minor	a.较小的，较少的，较次要的；少数的
minority	n.少数(民族); 少数
minute	n.分钟
miracle	n.sth.that is amazing and unusual 奇迹
mirror	n.镜子
miss	miss v.想念；思念 , n.小姐
missile	n.导弹
missing	a.失去的；缺少的
mission	n.代表团;使馆
missionary	a.传教的 n.传教士
mistake	n.错误
mix	v.混合
mixed	a.混合的；形形色色的
mixture	n.混合；混合物
mobile	a.活动的
mode	n.方式
model	n.模型；样式
moderate	a.中等的；稳健的，有节制的 v.(使)和缓
modern	a.现代的
modest	a.谦虚的
modify	vt.修改；变更
molecule	n.分子，克分子
mom	n.妈妈
moment	n.片刻，瞬间，时刻
momentum	n.动力，冲力，势头
money	n.货币，金钱
monitor	n.监控器；班长 vt./vi.监视，监控
monkey	n.猴子
monster	monster n.怪物；巨大的东西 , 妖怪
month	n.月
monthly	a.每月的；每月一次的
monument	n.纪念馆，纪念碑
mood	n.情，情绪
moon	n.月亮，月球，卫星
moral	a.道德上的
more	adj.更多的
moreover	ad.而且，此外
morning	n.早晨，上午
mortality	n.死亡率
mortgage	n.抵押
most	adv.,adj./n.最；非常；多数的；大部分
mostly	ad.主要地；大部分
mother	n.母亲
motion	vi.打手势；点(或摇)头示意
motivate	vt.促动；激励，激发
motivation	n.动因；动力
motive	n.动机，目的
motor	n.发动机；电动机
mount	mount v.登上，爬上，骑上 , n.(用于山名前)山，峰
mountain	n.山脉
mouse	n.鼠
mouth	n.嘴
move	v.移动
movement	n.运动
movie	n.电影
Mr	n.先生(用于男子姓或姓名前的称呼)
Mrs	Mrs n.夫人；太太(用于已婚妇女姓名前的称呼) , n. 夫人
Ms	ms 毫秒 , n．女士(用在婚姻状况不明的女子姓名前)
much	a.许多
mud	n.泥，泥浆
multiple	a.复合的，多次方的
municipal	a.市的，市政的
murder	n.&amp;vt.谋杀
muscle	n.肌肉；力量，实力
museum	n.博物馆
mushroom	n.蘑菇 v.迅速生长，迅速发展
music	n.音乐，乐曲
musical	a.of or for music 音乐的，和谐悦耳的
musician	n.音乐家；作曲家
Muslim	n.伊斯兰教徒
must	v.aux.必须
mutter	v.&amp;n.轻声低语；小声抱怨
mutual	a.相互的，共同的
my	my pron.我的 , 我的
myself	pron.我自己
mysterious	a.神秘的，难以理解的
mystery	n.神秘，神秘的事物
myth	n.神话，神话故事
nail	n.钉；指甲，爪
naked	a.裸体的
name	n.名字
narrative	n.叙述文，故事；叙述，讲述
narrow	a.狭窄的
nasty	n.卑劣的，下流的
nation	n.国家；民族
national	a.国家的
nationwide	a.全国性的 ad.在全国范围内
native	n.本地人 a.本国的
natural	a.自然的
naturally	ad.自然地
nature	n.自然，自然界；性质，本性，天性
naval	adj.海军的
near	a.不远；亲近的
nearby	ad.在附近
nearly	adv.几乎；将近
neat	a.整洁的
necessarily	ad.必定
necessary	a.必须的，必要的，必然的
necessity	n.需要，必要性；必需品
neck	n.脖子
need	n.&amp;v.必要，需要；必须
needle	n.针（状物）
negative	a.否定的，消极的，反面的
negotiate	v.协商，谈判；议定，商定
negotiation	n.谈判，协商
neighbor	n.邻居
neighborhood	n.邻近地区；地段
neighboring	adj.邻近的，相邻的
neither	pron.两者都不
nerve	神经，勇气
nervous	a.神经质的；紧张的
nest	n.巢，窝
net	vt.用网捕, 净赚, 得到
network	n.网状系统；广播网，电视网；广播联播公司
neutral	a.中立的，中性的
never	ad.从未；决不
nevertheless	conj.然而，不过
new	adj.新的
newly	ad.新近，最近；重新，以新的方法
news	n.新闻
newspaper	n.报纸
next	adv./adj.下一个；隔壁的
nice	a.美好的
night	n.夜，夜间
nightmare	n.恶梦
nine	num.九
no	adv./adj.不；不是
nobody	pron.没有人
nod	v.点头
noise	n.喧闹声；噪声
nomination	n.提名；任命
nominee	n.被提名者；被任命者
none	ad.毫不
nonetheless	ad.仍然，不过
nonprofit	a.非赢利的
noon	n.中午
nor	conj.也不
norm	n.准则，规范；平均数；通常情况
normal	a.正常的，正规的 n.正常状态
normally	ad.通常
north	n.北方
northeast	n．东北；东北部
northern	northern a.北方的 , 北爱尔兰
northwest	n.西北；西北部 a.朝西北部的 ad.在西北
nose	n.鼻子
not	ad.不
note	vt.记；注意
notebook	n.笔记本
nothing	pron.没有任何东西
notice	v.&amp;n.注意，认识；通知，通告
notion	n.concept 概念，意念；看法
novel	a.新颖的，新奇的
now	adv.现在interj.语气词(以引起他人的注意)
nowhere	ad.任何地方都不
nuclear	a.核子的，核能的；核心的，中心的
number	n.数字
numerous	a.许多的
nurse	n.&amp;v.护士，保姆，保育员；护理，养育
nut	n.坚果；螺母
nutrient	a.营养的，滋养的 n.营养物，营养品
oak	n.橡树
object	n.物体，对象，目的；宾语 v.反对(to)
objection	n.反对
objective	a.客观的；无偏见的
obligation	n.义务，责任
observation	n.注意，观察；观察物
observe	vt.观察
observer	n.遵守者，奉行者；观察者，监视者
obstacle	n.障碍，障碍物
obtain	v.获得，得到
obvious	a.明显的
obviously	ad.明显地，显而易见地
occasion	n.时刻，时机；场合
occasional	a.偶尔的，非经常的
occasionally	ad.偶尔地，间或
occupation	n.占有；占有期间
occupy	vt.占用，占领；使忙碌，使从事
occur	vi.发生
ocean	n.海洋
odd	a....以上的；奇特的；奇数的，单数的
odds	n.可能性；机会
of	prep.…的
off	ad.中断
offender	n.犯罪者，犯错误者
offense	n.不悦，恼怒
offensive	a.讨厌的；冒犯的，攻击的
offer	v.出价；出现
offering	n.提供之物
office	n.办公室；局
officer	n.军官；办事员，高级职员；警察
official	n.官员
officially	ad.官方地，正式地；公务上
often	ad.经常
oh	Oh interj.哦;啊呀 , int.啊；噢；呀
oil	n.油
ok	OK interj.好；行；对的 , adv. (口语)好；对；可以
OK	OK interj.好；行；对的 , adv. (口语)好；对；可以
okay	Okay (=OK)adv.&lt;表示同意或允许&gt;好的，可以，行 , a.行，可以
old	a.老的
old-fashioned	a.老式的
Olympic	a.奥运会的
Olympics	n.奥林匹克运动会
on	prep.在…之上
once	adv.一次；曾经
one	num.一；一个
ongoing	a.进行中的，前进的
onion	n.洋葱
online	adj．& adv．在线；上网
only	ad.仅仅；只
onto	prep.到…上，向…之上
open	v.&amp;a.打开，开始；开张；开
opening	a.开始的 n.开始；洞，孔；空缺
openly	ad.公开地
opera	n.a musical play 歌剧(院)
operate	vt.操作
operating	操作
operation	n.手术；运转
operator	n.操作人员
opinion	n.意见，主张，看法
opponent	n.对手；反对者
opportunity	n.机会，时机
oppose	vt.反对，反抗；使相对，使对抗(to)
opposed	a.相对的，相反的
opposite	n.对立面，对立物
opposition	n.反对，反抗；对立，意见相反
opt	vi.抉择，选择(for)，在…之间选择
optimistic	a.乐观的；乐观主义的
option	n.选择
or	conj.或者
oral	a.口头的，口的
orange	Orange 奥兰治(地名) , n.橘子
orbit	vt./vi.绕(…的)轨道运行 n.轨道
order	n.次序；整齐
ordinary	a.平常的；普通的
organ	n.器官；风琴；机构
organic	a.有机（物）的
organism	n.生物体, 有机体
organization	n.组织，机构
organizational	a.组织的
organize	vt.组织
organized	adj.有条理的;有效率的
orientation	n.方位；定位；取向
origin	n.血统；出身；起源
original	a.起初的，原来的；独创的 n.原物；原文
originally	ad.起初，原来
other	a.其他的 pron.其他
others	prep.(pl.)另外的人
otherwise	ad.否则的话 a.另外的；其他方面的
ought	v.aux.应当；应该
our	pron.我们的
ours	pron.我们的
ourselves	pron.我们自己
out	adj.(花)盛开的
outcome	n.结果，结局；出路，出口
outdoor	a./ad.户外的，野外的；户外，野外
outer	adj.外部的
outfit	n.(尤指在特殊场合穿的)全套服装
outlet	n.出口, 出路
outline	n.大纲
output	n.产量；输出
outside	n.外面
outsider	n.局外人，外人
outstanding	a.杰出的
oven	n.烤炉，烤箱
over	a.结束的
overall	a.all 全面的
overcome	vt.战胜, 克服, 胜过, 征服
overlook	vt.俯视；忽略
overnight	a.住一夜的；一整夜的
oversee	v.监督
overwhelm	v.使受不了，使不知所措
overwhelming	a.势不可挡的；压倒之势的
owe	vt.欠(债等)；应把…归功于(to)
own	a.自己的 v.承认
owner	n.所有者
ownership	n.拥有；所有权，所有制
oxygen	n.氧，氧气
pace	n.(一)步；步速，节奏 vi.踱步；用步量
pack	vt.把(东西)打包(或装箱)
package	vt.组装
pad	n.便笺薄
page	n.页；记录
pain	vt.使痛苦
painful	a.痛苦的；费力的
paint	v.画，绘；涂油漆，着色 n.油漆；颜料
painter	n.漆工；画家
painting	n.画；绘画，绘画艺术；(上)油漆
pair	n.(一)对，(一)双
palace	n.宫殿
pale	n.栅栏 a.苍白的
Palestinian	a.巴勒斯坦的
palm	n.手掌
pan	n.平底锅；盘子；盆子
panel	n.专门小组
panic	n.恐慌
pant	vi.喘；渴望vt.气喘吁吁地说n.喘息
paper	n.纸，报纸
parade	vt.使列队行进 n.游行；检阅
parent	n.父，母
parental	a.父母(似)的
parish	n.教区
park	n.公园
parking	n．停车(处)
part	n.部分
partial	a.部分的，不完全的；偏袒的
partially	ad.部分地；不完全地
participant	n.参加者 a.参与的
participate	vi.参与，参加
participation	n.参加，参与
particle	n.粒子；微粒
particular	n.细节
particularly	ad.especially 特别地，尤其
partly	ad.部分地；在一定程度上
partner	n.伙伴；合伙人；合伙者
partnership	n.合作关系，伙伴关系
party	party n.聚会 , n.共产党(小写指党)
pass	v.经过；通过
passage	n.通道；通过
passenger	n.乘客，旅客
passion	n.激情
past	a.&amp;n.&amp;prep.过去的；过去；过，经过
pasta	n.意大利面制品；意大利面食(包括细面条等)
pastor	n.牧师
pat	Pat (狗名) , n.轻拍 v.轻抚 [同]tap
patch	n.补片，补丁，斑 vt.修补(衣服等的洞等)
patent	v.取得专利权
path	n.小路，路线，途径
patience	n.耐性，忍耐
patient	a.&amp;n.有耐心的，能忍耐的；病人，患者
patrol	n.巡逻队
patron	n.庇(保)护人; 赞助人
pattern	n.模式
pause	vi./n.暂停，中止
pay	v.&amp;n.付款，交纳；工资，薪饷
payment	n.付款
PC	个人计算机
peace	n.和平，平静
peaceful	a.平静的，安宁的；和平的，和平方式的
peak	n.顶峰；山峰
peanut	n.花生；[pl.]很少的钱
peasant	n.农夫
peel	n.(水果、蔬菜)皮 vi.剥落 vt.削去...的皮
peer	n.同等的人, 贵族
pen	n.笔；钢笔
penalty	n.惩罚
pencil	n.铅笔
pension	n.养老金；退休金；抚恤金
people	n.人
pepper	n.辣椒
per	prep.每，每一
perceive	vt.察觉，发觉；理解
percentage	n.百分比，百分率
perception	n.认识，看法；感知（能力），觉察
perfect	a.完美的
perfectly	ad.完美地，十分，非常
perform	vt.做，履行
performance	n.成绩
performer	n.演出者，表演者；履行者，执行者
perhaps	ad.也许，恐怕，大概
period	n.期间，一段时间
permanent	a.持久的；永久的
permission	n.允许，许可，同意
permit	v.允许，许可
Persian	n.波斯人
persist	vi.坚持，固执(in)；持续，存留
person	n.人
personal	a.私人的，个人的
personality	n.个性
personally	ad.亲自，当面；就个人而言；个别地
personnel	n.全体人员，全体职员
perspective	n.观点，看法
persuade	vt.说服，劝服；使相信 a.空闲的；有闲的
pet	n.爱畜；宠物；受宠爱的人
phase	n.阶段；时期
phenomenon	n.(phenomena)现象，迹象
philosophical	a.哲学家的；哲学(上)的
philosophy	n.哲学
phone	n.电话(机)；受话器，耳机 v.打电话
photo	n.相片
photograph	vt.给...拍照；拍摄 n.照片；相片
photographer	n.摄影师
photography	n.摄影，照相；摄影术
phrase	n.短语
physical	a.身体的；物质的；物理学的
physically	ad.身体上；实际上；按自然规律
physician	n.内科医生
physics	n.物理学
piano	n.钢琴
pick	v.摘；拾取
pickup	n.小卡车；轻型货车
picture	n.图画
pie	n.馅饼
piece	n.片
pig	n.猪，猪肉；猪一般的人(指肮脏，贪吃的人)
pile	n.堆
pill	n.药丸
pillow	n.枕头
pilot	n.机师；飞行员
pin	vt.(用大头针等)别住，钉住 n.大头针；别针
pine	n.松树；松木
pink	a.粉红色的，桃红色的 n.粉红色，桃红色
pioneer	n.先锋；开拓者
pipe	n.管子，导管；烟斗 vt.用管道输送
pistol	n.手枪
pit	n.(地面的)坑，洼；(田径场上的)沙坑
pitch	n.声音的高低，调子
pitcher	n.有柄水罐
pizza	n.意大利馅饼，比萨饼
place	n.地方
placement	n.放置，(人员的)安排
plain	n.简朴的
plaintiff	n.[律]原告
plan	v.&amp;n.计划，打算
plane	n.飞机
planet	n.行星
planner	n.计划者，计划制订者
planning	计划
plant	n.植物
plastic	a.塑料的 n.(pl.)塑料
plate	n.盘子
platform	n.月台
play	v.&amp;n.玩，游玩；演奏
player	n.运动员，做游戏的人；演员，演奏者
playoff	n.季后赛
plea	n.恳求
plead	vi.恳求
pleasant	a.令人愉快的，舒适的
please	vt.使喜欢；请
pleased	adj.满意的；高兴的
pleasure	n.愉快；乐趣
plenty	n.丰富，富裕；大量
plot	vt.绘图
plunge	v.投身于；纵身投入；一头扎入
plus	prep.加，加上 a.正的；附加的
PM	下午
pocket	n.衣袋
poem	n.诗
poet	n.诗人
poetry	n.诗篇，诗歌
point	n.点 v.指向；指出
poke	vt.戳，捅；摸索地走
pole	n.极(点)
police	n.警察 a.警察机关的
policeman	n.警察
policy	n.a method orplan for action 政策
political	a.政治的
politically	ad.政治上
politician	n.政治家; [贬]政客
politics	n.政治
poll	n.民意测验
pollution	n.污染
pond	n.池塘; 鱼塘
pool	n.池 vt.合伙
poor	a.穷；可怜的；低劣的，不好的
pop	n.现代流行风格（尤指音乐的）
popular	a.流行的；受欢迎的
popularity	n.普及，流行；名望，受欢迎
population	n.人口
porch	n.门廊
pork	n.猪肉
port	n.港口；端口
portfolio	n.（个人或公司所持有的）有价证券；公文包
portion	n.一部分；一份
portrait	n.肖像，照片
portray	vt.描绘；描写；描述
pose	vt.摆姿势, 佯装, 矫揉造作
position	n.位置 vt.安置
positive	a.无疑问的；确定的；肯定的；正面的
possess	vt.占有，拥有
possession	n.有，拥有；［常pl.］占有物；财产
possibility	n.可能(性)；可能的事
possible	a.可能的，做得到的
possibly	ad.可能地，也许；无论如何
post	n.&amp;v.邮政；邮寄，投寄
poster	n.招贴，海报
pot	n.罐；壶
potato	n.马铃薯
potential	n.潜力
potentially	ad.可能地，潜在地
pound	v.强烈打击
pour	vt.灌注
poverty	n.贫穷
powder	n.粉末，药粉；香粉，爽身粉；火药，炸药
power	n.握有大权的人物；有影响的机构；强国
powerful	a.强大的，有力的；有权力的
practical	a.实用的；实际的
practically	ad.实际上
practice	n.实践，实施；练习，实习
practitioner	n.开业者(尤指医生、律师等)
praise	n.表扬，称赞 v.表扬，赞扬
pray	vi.祈祷
prayer	n.祈祷，祷告；[常作prayers]祈祷仪式
preach	vt.宣讲，布道；鼓吹
precious	a.珍贵的
precise	a.精确的，严格的
precisely	ad.exactly, accurately
predator	n.食肉动物
predict	vt./vi.预言；预示
prediction	n.预言，预计；预报
prefer	vt.更喜欢；宁愿
preference	n.(for，to)偏爱；优先(权)
pregnancy	n.怀孕，怀孕期
pregnant	a.怀孕的，妊娠的
preliminary	adj.初步的，预备的
premise	n.前提；假设
premium	n.加付款；赠品a.高级的；售价高的
preparation	n.准备，预备
prepare	v.准备，预备
prescription	n.处方的药；处方，药方
presence	n.出席，到场
present	vt.赠送；提供
presentation	n.提出，呈递；介绍，报告
preserve	vt.保护；保存
presidency	n.总统(或校长)职务(职权，任期)；管辖
president	n.主席，总统，校长，总经理
presidential	a.总统(校长)的；总统(校长)职务的
press	Press n.新闻界 , v.按，压
pressure	n.压力，压强
presumably	ad.推测起来，大概
pretend	v.假装
pretty	a.漂亮，俊俏
prevail	vi.胜过；流行，盛行
prevent	vt.防止
prevention	n.阻止，妨碍，预防
previous	a.以前的
previously	ad.以前
price	n.价格
pride	n.骄傲；自豪
priest	n.牧师；教士；神父
primarily	ad.主要地
primary	a.首要的；最初的
prime	a.最初的，基本的；主要的；最好的
principal	a.主要的
principle	n.原理，原则；主义，信念
print	v.打印
prior	a.较早的，在前的
priority	n.优先考虑的事；优先(权)
prison	n.监狱
prisoner	n.囚犯；俘虏
privacy	n.私事，私生活；隐私；独处
private	a.私人的；私营的；秘密的，私下的
privately	ad.非公开的；在涉及私(个)人方面；秘密地
privilege	n.特权
prize	n.奖；奖品；奖金
pro	ad.从正面 n.赞成的意见；赞成者
probably	ad.很可能，大概，或许
problem	n.问题
procedure	n.程序
proceed	vi.(停顿后)继续进行
process	n.过程；制作法
processing	处理
processor	n.(农产品的)加工业者；(信息)处理机
proclaim	vt.宣告，宣布，声明；显示
produce	vt.生产；制造 n.农产品
producer	n.制片人
product	n.产品，产物
production	n.生产，产量
productive	a.多产的，富有的
productivity	n.生产率；丰饶，多产
profession	n.职业(尤指脑力劳动或受过专业训练的)
professional	a.职业的 n.以特定职业谋生的人
professor	n.教授
profile	n.人物简介；侧影 vt.写…的传略
profit	n.益处，利益
profound	a.深刻的，浑奥的
program	n.=programme计划；程序；节目 vt.编程序
programming	程序设计
progress	n.&amp;v.前进，进步，进展
progressive	a.(疾病等)愈来愈重的；向前的；进步的
prohibit	vt.禁止
project	n.项目；方案
projection	n.凸出物
prominent	a.突出的，显著的
promise	v.允诺；答应
promising	a.有希望的；有前途的
promote	vt.促进，发扬；提升，升级；发起，创办
promotion	n.促进；提升
prompt	vt.促进；激起
proof	n.证据，证明；校样
proper	a.适当，恰当
properly	ad.正确地，适当地；真正地
property	n.财产
proportion	n.比率，比例；大小
proposal	n.提议，建议
propose	v.提出，建议；提名，推荐
proposed	被提议的
prosecution	n.控方，代表原告的律师
prosecutor	n.起诉人；检察官，公诉人
prospect	n.期望中的事；展望；前景
protect	vt.保护
protection	n.保护
protective	a.给予保护的，防护的
protein	n.蛋白质
protest	vt./vi.抗议，反对
protocol	n.外交礼节；礼仪
proud	a.自豪的
prove	v.证明；原来
provide	v.供应
provided	conj.假如，若是
provider	n.供应者；提供者；养家糊口的人
province	n.省
provision	n.供应，供应品；条款，规定；给养
provoke	vt.激起，引起(感情、反应)
psychological	a.心理的
psychologist	n.心理学家
psychology	n.心理学；心理
public	n.公众
publication	n.公布；出版；出版物
publicity	n.宣传，广告
publicly	ad.公开地
publish	vt.出版，刊印；公布，发表
publisher	n.出版商，发行人
pull	v.&amp;n.拖；拉
pulse	n.脉搏
pump	vt.(用泵)抽水 n.泵
punch	vt.用拳猛击
punish	v.处罚，惩罚
punishment	n.惩罚
purchase	vt.买，购买 n.购买，购买的物品
pure	a.纯，纯洁；十足，完全
purple	n.紫色，紫红色 a.紫色
purpose	n.目的；打算
purse	n.钱包
pursue	vt.从事；忙于；继续
pursuit	n.追踪，追捕；追求，寻求；乐趣，消遣
push	vt./vi.推；按
put	v.放，置
puzzle	vt.使迷惑
qualify	v.(使)取得资格
quality	n.质量；品质
quantity	n.量, 数量
quarter	n.(都市的)区；街
quarterback	n.(橄榄球比赛中的)四分卫
queen	n.女王
quest	v.寻求，搜索，追求
question	n.问题 v.询问
questionnaire	n.问题单，调查表
quick	a.&amp;ad.快
quickly	ad.快地，急速；立刻地，马上
quiet	a.安静的
quietly	ad.安静地；轻声地；轻轻地
quit	v.离(职)，不干
quite	ad.十分；非常
quote	vt.引用，引述
rabbit	n.兔
race	n.属；人种
racial	a.种族的
racism	n.种族歧视，种族偏见；种族主义
rack	vt.猛力摇动
radar	n.雷达
radiation	n.放射，辐射；放射物
radical	a.根本的，基本的；激进的
radio	n.收音机
rage	vi.(烈火)熊熊燃烧；发怒；怒斥；季风
rail	n.栏杆
railroad	n.铁路
rain	vi.下雨
raise	vt.上升
rally	v.召集，团结 n.群众集会
ranch	n.大牧场，大农场
random	a./ad.胡乱的，任意的，随便的 n.无目标
range	n.范围 vt.(在一定范围内)变动 vi.论及
rank	n.排，行列；等级，地位
rape	vt.／n.强奸
rapid	a.迅速的
rapidly	ad.快速地，迅速地
rare	a.稀有的；杰出的
rarely	ad.很少，难得
rat	n.鼠
rate	n.率
rather	ad.有些，相当；宁可，宁愿
rating	n.等级，规格； (电视)收视率
ratio	n.比(率)
rational	a.理性的，合理的
raw	a.未煮过的，生的；未加工的
re	prep.关于
reach	v.&amp;n.伸手，够到，触到；到，到达
react	vi.反应
reaction	n.反应(力)，反作用(力)；反动，对抗
read	vt./vi.朗读；阅读
reader	n.读者
readily	ad.乐意地；很快地，容易地
reading	n.读；读物；(仪表盘上的)读数，指示数
ready	a.有准备的
real	a. 真，真实；实际的，现实的
realistic	a.现实的，实际的；现实主义的
reality	n.真实, 事实, 本体, 逼真
realize	v.认识到，体会到，实现
really	ad.确实，实在，真正地
realm	n.领域；王国
rear	n.&amp;a.后面（的），后部（的）
reason	n.理由，原因；理性
reasonable	a.合情理的，适度的
rebel	n.反叛者
rebuild	v.再建，改建；改造，使复原
recall	vt.记得；回忆起
receive	v.收到，接到；接待，接受
receiver	n.电视或收音机的接收器；电话听筒
recent	a.新近的，近来的
recently	ad.最近
reception	a.招待会
recession	n.(工商业的)衷退(期)，萧条(期)
recipe	n.烹饪法，食谱；方法，秘诀，诀窍
recipient	n.接受者，接收者
recognition	n.认出；承认，公认
recognize	v.认出，识别，承认
recommend	vt.建议；推荐
recommendation	n.推荐信；建议
record	n.档案 v.记录；录音
recording	n.录制(尤指广播，电视等)节目
recover	vi.恢复，痊愈 vt.重新获得；收回，挽回
recovery	n.痊愈；复得
recruit	vt./vi.征募(新兵)，吸收；补充 n.新成员
red	adj.红色的 n.红色
reduce	vt.减少；降低
reduction	n.减少，减小，缩减
refer	vi.(to)提到，涉及
reference	n.参考；涉及
reflect	v.反射(光、热、声等)；反映；表明
reflection	n.反映；(光、热、声等的)反射
reform	n.改革;改良;革除
refrigerator	n.冰箱
refuge	n.避难(所)，庇护(所)
refugee	n.流亡者，难民
refuse	v.拒绝，推辞
regain	v.收回；恢复(健康)
regard	vt.把…看作；把…认为(as)
regarding	prep.关于，在...方面
regardless	a.不论，不顾
regime	n.政体，政权；制度
region	n.地区，区域
regional	a.地区的，局部的
register	vt.取得，登记
regret	v.&amp;n.遗憾，懊悔，抱歉
regular	a.定时的，定期的；规则的
regularly	ad.整齐地，经常地，定期地
regulate	vt./n.管理；调节
regulation	n.规章；规则
regulator	n.调节器，校准器
regulatory	a.规章的；调节的
rehabilitation	n.康复；(罪犯的)改造
reinforce	vt.加强
reject	vt.拒绝
relate	vi.有关联 vt.讲述；使互相关联
related	a.有关的，相关的(to)；有亲戚关系的
relation	n.亲属，亲戚；关系，联系
relationship	n.关系，联系
relative	a.有关系的，相对的，比较而言的
relatively	ad.比较而言；相对地
relax	v.放松；休息
release	n./vt.释放；发布，发行；放开，松开
relevant	a.有关的，贴切的
reliability	n.可靠性
reliable	a.可靠的，可信赖的
relief	n.救济
relieve	vt.减轻
religion	n.宗教；宗教信仰
religious	a.宗教的
reluctant	a.不愿意的，勉强的
rely	vi.依赖；信任；信赖
remain	v.剩下，余留；保持，仍是
remaining	a.剩余的
remark	vt./vi.说，评论，议论 n.评论，看法
remarkable	a.显著的；非凡的
remember	v.回忆起；记得
remind	v.提醒，使想起(of)
reminder	n.提醒者，提醒物；暗示，提示
remote	a.遥远的，细微的
removal	n.移动；迁移；除掉；排除
remove	v.排除，消除，去掉；摘掉
render	vt.致使，使成
rent	n.租金 vt.租用；出租
rental	a.租来的 n.租金
repair	v.&amp;n.修理
repeat	v.重复，重说，重做，反复说
repeatedly	ad.反复地
replace	vt.把…放回(原处)；更换，以…替代
replacement	n.复位，复职；替换，代替
reply	n.&amp;v.答复，回答
report	v.&amp;n.报告，汇报，报道
reportedly	ad.据报道，据传闻，根据传说
reporter	n.记者
represent	vt.代表；象征；体现
representation	n.描写，表现；代表，代理
representative	n.代表，代表人 a.典型的，有代表性的
republic	n.共和国
Republican	Republican a.&amp;n.共和党的;共和党人 , a.共和国的；共和党的 n.共和党党员
republican	Republican a.&amp;n.共和党的;共和党人 , a.共和国的；共和党的 n.共和党党员
reputation	n.声誉，声望；名声；好名声
request	vt.请求
require	v.需要；要求
required	必需
requirement	n.要求；必要条件
rescue	vt. save from danger 拯救，营救，挽救
research	n.研究，调查 vi.调查，研究
researcher	n.研究者，调查者，探索者
resemble	vt.类似于，象
reservation	n.保留；保留意见；预订的席位(或住处等)
reserve	vt.保留；预订 n.保留；储备；禁猎区
residence	n.住所；住宅；公馆
resident	n.居民
residential	a.(市镇的)居住的；住宅区的
resign	v.辞去
resist	vt.抵抗, 反抗, 抗, 忍得住
resistance	n.抵抗；抵制；抵抗力
resolution	n.决心，坚定；决定
resolve	vt.解决
resort	v.求助于，诉诸于
resource	n.资源
respect	v.&amp;n.尊敬；尊重
respectively	ad.各自地，分别地
respond	vi.回答，答复；响应，有反应(to)
respondent	n.被告
response	n.作答，回答；响应，反应
responsibility	n.责任，责任心；职责，义务
responsible	a.应负责的，有责任的
rest	n.&amp;v.(使)休息，(使)睡眠
restaurant	n.餐馆
restore	vt.使恢复，(使)回复
restrict	vt.限制，约束
restriction	n.限制；约束
result	n.结果，成果，成绩
resume	n.摘要，梗概；个人简历
retail	n.零售；零卖
retailer	n.零售商
retain	v.记住
retire	vi.退出
retired	adj.退休的
retirement	n.退休
retreat	vi.退缩；退却，撤退
return	v.&amp;n.回来；归还
reveal	vt.揭露
revelation	n.揭示，暴露
revenue	n.收入；收益
reverse	n.相反，背面
review	n.&amp;vt.回顾；复习
revolution	n.革命
revolutionary	a.革命（性）的；重大变革的
reward	n./vt.酬劳，奖赏；报答
rhetoric	n.修辞(艺术)；修辞学
rhythm	n.节奏
rib	n.肋骨
ribbon	n.(缎或丝)带，带状物
rice	n.稻，米
rich	a.富有的
rid	vt.使摆脱，使去掉
ride	v.骑；乘
rider	n.骑手，骑车人
ridge	n.山脊，山脉；屋脊
ridiculous	a.荒谬的，可笑的；荒唐的
rifle	n.步枪
right	Right a.好的，行 , adj.正确的，右的
rim	n.(圆形物体的)边，缘vt.绕...边缘
ring	v.&amp;n.敲钟，打铃；铃声，钟声；(打)电话
riot	n.暴乱
rip	v.撕裂或拉破
rise	vi.升起；发源；起立
risk	n.风险，危险 vt.冒…的风险；使遭受危险
risky	a.有风险的
ritual	n.仪式，典礼 a.仪式的，典礼的
rival	n.对手；敌手
river	n.江，河
road	n.路，道路，途径
robot	n.机器人；自动控制装置
rock	n.岩石 v.摇摆
rocket	n.火箭
rod	n.杆，棒条
role	n.角色；作用
roll	v.绕，卷
rolling	a.绵延起伏的
Roman	Roman n.罗马人 a.罗马的；罗马人的；拉丁的 , n.古罗马人 a.罗马的
romance	n.浪漫文学，浪漫故事
romantic	a.浪漫的；幻想的
roof	n.屋顶
room	n.房间
root	v.(使)生根；(使)固定
rope	n.绳，索
rose	n.玫瑰
rough	a.粗糙的；粗野的；粗略的，大致的
roughly	ad.粗略地，概略地
round	a.圆的 ad.在周围 prep.围绕着 n.一圈
route	n.路线；航线
routine	a.常规的，例行的
routinely	ad.通常
row	v.划(船桨等)，荡桨
royal	a.皇家的；王室的
rub	n.摩擦；疑难点
rubber	n.橡皮；橡胶
ruin	v.破产
rule	n.规则；惯例
ruling	n.裁决
rumor	n.谣言；传闻
run	v.奔，跑，逃跑；流，淌
runner	n.赛跑者
running	n.跑，赛跑；竞选
rural	a.(像)乡村的；有乡村(生活)特点的
rush	v.冲击
Russian	Russian a.俄罗斯(人/语)的 n.俄语，俄罗斯(人) , n. 俄语
sack	n.袋；解雇；床 vt.解雇；掠夺
sacred	a.神圣的
sacrifice	n.牺牲 vt.牺牲
sad	adj.难过的；悲伤的
safe	a.安全；牢靠
safely	ad.安全地，平安地；确切地，没错地
safety	n.安全
sail	n.帆；风车翼板 v.航行，乘船旅行；启航
sake	n.理由；目的；缘故；利益
salad	n.色拉
salary	n.工资 vt.[常用被动语态]给…发薪
sale	n.出售，卖；廉价出售
sales	n.展销；廉价销售
salmon	n.鲑鱼
salt	n.盐；经验丰富的老水手 vt.腌制
same	adj.同样地；一样的
sample	n.样品，标本 vt.从…抽样
sanction	vt.同意，批准，认可
sand	n.沙，(pl.)沙滩
sandwich	n.三明治
satellite	n.(人造)卫星
satisfaction	n.满意，满足
satisfy	v.满足，使满意
sauce	n.调味汁，沙司
save	vt.救助，搭救；储蓄，积攒；节省
saving	n.节省，节约；(pl.)储蓄金，存款
say	v.说
scale	n.刻度，表度；规模；比例(尺)；天平
scan	vt.细看，审视；浏览，粗看；扫描
scandal	n.丑行；丑事；丑闻
scare	v.惊吓
scared	a.害怕
scary	a.令人害怕的
scatter	vt.撒播；使散开，驱散 vi.分散，消散
scenario	n.事情发展的概述
scene	n.景色，景象
scent	n.气味；臭迹，线索；香水vt.嗅到
schedule	n.时间表
scheme	n.计划；方案 vt./vi.计划，策划
scholar	n.学者
scholarship	n.学识，学术成就；奖学金
school	n.学校，学院
science	Science 科技课 , n ．科学；学科
scientific	a.科学的
scientist	n.科学家
scope	n.(活动，影响能力等的)范围
score	n.得分；乐谱 v.得(分) vt.为…配乐
scramble	n.爬行，攀爬
scratch	v.抓；擦；乱涂
scream	v.尖声叫
screen	n.银幕；屏幕
screening	n.上映，放映；筛选，资格审查，选拔
screw	n.螺丝钉
script	n.手迹；手稿
sculpture	n.雕塑
sea	n.海，海洋
seal	n.印，图章
search	v.&amp;n.搜索，寻找，探查
season	n.赛季
seat	n.座位
second	num.第二 a.第二的 n.秒
secondary	a.第二位的，次要的；中等的
secret	a.&amp;n.秘密的，机密的；秘密，奥秘
secretary	Secretary 部长 , n.秘书
section	n.(文章等的)段落；节；部分
sector	n.部分，部门
secular	a.现世的，世俗的；非宗教的
secure	a.安全的
security	n.安全
see	v.看见
seed	n.种子
seek	v.寻找
seem	vi.像是
seemingly	ad.表面地；近乎真实地
segment	n.切片，部分；段，节
seize	v.抓住
seldom	ad.很少
select	vt./vi.选择，挑选，选拔 a.精选的
selected	a.精选的
selection	n.挑选
self	n.自己
self-esteem	n.自尊
sell	v.卖
seller	n.卖者；销售物
seminar	n.专题讨论会；短期强化课程
Senate	senate n.参议院，议会，最高立法机构 , n.参议院，议会，最高立法机构
senator	n.参议员，上议员
send	vt.寄送
senior	a.&amp;n.（大学）四年级的（学生）
sensation	n.感觉能力；感觉；(引起)轰动的事件(人)
sense	n.见识 vt.理解
sensitive	a.敏感的；灵敏的，感光的
sensitivity	n.敏感性；灵敏度
sensor	n.传感器；探测设备；感觉器(官)
sentence	n.句子
sentiment	n.感情，情绪；感伤
separate	a.分离的，分开的 v.分离，分开
separation	n.分开，分类；分隔
sequence	n.顺序；连续；一连串
series	n.一系列，连续；丛书，套；［电］串联
serious	a.严肃的
seriously	ad.严肃地；认真地；严重地
servant	n.仆人
serve	v.服务，尽责；侍候，招持
service	n.服务 v.保养
session	n.会议；(从事某项活动的)一段时间
set	v.&amp;n.放，安置；(太阳)落山；接收机
setting	n.环境，背景；调节(点)，(舞台等的)布景
settle	v.定居；安排 n.长凳
settlement	n.定居；移民，殖民；殖民地；居留地
seven	num.七
seventh	num.第七
several	a.几个
severe	a.严重的；严肃的
severely	ad.严厉地，苛刻地
sex	n.性；性别
sexual	a.性的；性
sexuality	n.性生活；性别
sexually	ad.在性方面
sexy	a.性感的
shade	n.荫，阴影 vt.遮蔽，遮光
shadow	n.影子，阴影
shake	v.&amp;n.摇动；颤动
shall	v.aux.将
shallow	adj.浅的
shame	n.害羞
shape	n.&amp;v.形状，外形；形成，成形
share	vt./vi.共同使用；分享
shareholder	n.股东
shark	n.鲨鱼；勒索者，诈骗者，放高利贷的人
sharp	n.高调 a.锐利的
sharply	ad.严厉地
she	pron.她
shed	vt.摆脱，去除
sheep	n.羊，绵羊
sheer	a.完全的，十足的，透明的；陡峭的，垂直的
sheet	n.片
shelf	n.(壁橱，书橱内)搁板；架子
shell	n.壳，英，炮弹，外壳
shelter	n.躲避处，掩蔽部；牲畜棚
shift	n.班；轮班
shine	v.发光，照耀；使发光，擦亮
ship	n.船
shirt	n.衬衫
shit	n.讨厌的家伙；粪便 int.胡说
shock	vt.使(某人)震惊
shoe	n.鞋
shoot	v.射击
shooting	n.开枪，射杀
shop	n.&amp;v.商店，店铺；购物
shopping	n.买东西，购物
shore	n.岸；海滨
short	adj.短的
shortage	n.不足，缺少，短缺
shortly	ad.不久，马上
shorts	n.短裤
short-term	a.短期的
shot	n.射击；弹丸，子弹；射门，投篮
should	v.aux.应该；将要
shoulder	n.肩，肩膀
shout	v.&amp;n.呼喊，呼叫；叫声
shove	vt.乱推；乱塞vi.用力推，挤n.猛推
show	show v.展示 n.外观 , 显示
shower	n.阵雨，暴雨
shrimp	n.(小)虾
shrink	vi.减少；变小
shrug	v.耸肩
shut	vi.关上
shuttle	n.航天飞机；梭子v.穿梭来回(运送)
shy	a.害羞的；胆怯的
sibling	n.兄弟（或姐妹），同胞
sick	n.病人 a.不舒服的
side	n.旁边
sidewalk	n.人行道
sigh	vi.叹气
sight	n.风景
sign	n.符号，标记，招牌
signal	n.信号
signature	n.签名；签字，签署
significance	n.意义，意味；重要性
significant	a.重大的
significantly	ad.有意义地，意味深长地；重大地
silence	n.&amp;v.寂静，沉静；使寂静，使沉默
silent	a.沉默的；寂静的
silk	n.丝绸
silly	a.愚蠢的
silver	n.银子
similar	a.类似的
similarity	n.相似，类似
similarly	ad.相似地，类似地
simple	a.简单的
simply	ad.仅，只；完全地；朴素地
simultaneously	ad.同时地
sin	n.(违背宗教等)罪(孽)，罪恶；过失，过错
since	conj.从…以后
sing	v.唱，唱歌，鸣叫
singer	n.歌唱家，歌手
single	a.单一的
sink	v.下落，下沉；坐下
sir	n.先生
sister	n.姐；妹
sit	v.坐；就座
site	n.地点，地基；场所
situation	n.形势，局面
six	num.六
sixth	num.第六
size	n.大小，尺寸；号码  v.按大小排列或分类
ski	n.滑橇 a.滑雪（用）的
skill	n.技巧，熟练
skilled	a.熟练的
skin	n.皮，皮肤
skip	vt.略过
skirt	n.裙子
skull	n.颅骨，脑壳
sky	n.天，天空
slam	vt.砰地关上
slap	vt.掴，掌击
slave	n.奴隶，苦工
slavery	n.奴隶制度；奴隶身份
sleep	v.睡觉
sleeve	n.袖子
slice	n.薄片 v.切，割
slide	v.(使)滑动
slight	a.微小的，轻微的
slightly	ad.稍微地
slip	vi.滑动，滑过；溜，溜走 vt.使滑动
slope	n.倾斜；斜面
slot	n.狭槽，口
slow	a.慢的
slowly	ad.慢慢地
small	a.小的
smart	Smart 斯马特 , a.漂亮的;聪明的;巧妙的 v.剧痛,刺疼
smell	v.闻
smile	n.&amp;v.微笑
smoke	n.烟
smooth	vt.把…弄平
snake	vt.用长铁丝通条疏通(管道)
snap	vt.厉声说
sneak	v.潜行，溜
snow	n./vi.雪；下雪
so	ad.因此
soak	v.湿透
soap	n.肥皂
soar	vi.翱翔; 剧增
so-called	a.所谓的，号称的
soccer	n.(美)英式足球
social	a.社会的
socially	ad.在社交方面，善于交际地
society	n.社会
sock	n.短袜
sodium	n.[化]钠
sofa	n.(长)沙发
soft	a.柔软，温柔，柔和
soften	v.缓和，减轻；变软，软化
softly	ad.柔软地，温和地
software	n.(计算机的)软件
soil	n.土壤，土地 vt.弄脏
solar	a.太阳的，太阳产生的；利用太阳光的
soldier	n.士兵
sole	a.唯一的
solely	ad.独自地，单独地
solid	n.固体
solution	n.解答，解决办法；溶解，溶液
solve	v.解决
some	a.&amp;pron.一些
somebody	pron.某人，有人 n.重要人物
someday	ad.有朝一日
somehow	ad.不知怎地；以某种方式
someone	pron.某人
something	pron.某事(物)
sometime	ad.在某一时刻
sometimes	ad.不时；有时
somewhat	ad.有点，稍微
somewhere	adv.到某处；在某处
son	n.儿子
song	n.歌曲
soon	adv.不久
sophisticated	a.老于世故的，高级的，尖端的
sorry	adj.抱歉的；对不起；遗憾的；难过的
sort	n.种类 vt.分类
soul	n.灵魂，心灵；精神，精力
sound	n.&amp;v.声音，声响；发声
soup	n.汤
source	n.(来)源；源头
south	south n.南，南部 , 南达科他州(美国)
southeast	n.东南(部) ad.朝东南方向 a.(朝)东南方的
southern	a.南的
southwest	n.西南 ad.在西南 a.向西南的；位于西南的
sovereignty	n.国家的主权，最高统治权
Soviet	a.苏联的，苏维埃的
space	n.空间；余地
Spanish	a.,n.西班牙的，西班牙人的；西班牙语
spare	a.&amp;v.多余的，备用的；节约，抽出(时间)
spark	n.火花，火星 vi.发火花 vt.激发，引起
speak	v.说话，讲
speaker	n.说话者，演讲者；扬声器
special	a.专门的，特殊的
specialist	n.专家；专门人才
specialize	vi.专门研究；专营(in)
specialty	n.专业
species	n.物种
specific	a.特有的，特定的；具体的，明确的
specifically	ad.特别，专门
specify	vt.明确说明，具体指定
spectacular	a.壮观的；惊人的
spectrum	n.光谱；波谱
speculate	vi.思索；推测vt.投机；思索，推测
speculation	n.guess
speech	n.演说
speed	Speed 《生死时速》(电影名) , n.速度,快 v.迅速,前进,急行;加速,使加速
spell	n.魅力 v.拼写
spend	vt.度过
sphere	n.范围，领域
spill	vt./vi.使溢出，使散落；溢出
spin	v.&amp;n.旋转，自转
spine	n.脊柱；脊椎
spirit	n.精神；妖精 v.鼓励
spiritual	adj.精神(上)的，心灵的
spit	vt.吐出
spite	n.虽然，不顾，尽管
split	vi.撕裂；分裂 vt.劈开 n.分裂，裂口
spokesman	n.发言人；代言人
sponsor	vt.发起，主办；资助 n.发起者，资助人
spoon	n.调羹
sport	n.运动
spot	n.地点，处所；点 vt.点缀；认出，准确定位
spouse	n.配偶 vt.和…结婚
spray	vt.喷洒
spread	v.伸展，展开；散布，传播
spring	n.泉水；喷泉；春天，春季
sprinkle	v.撒，洒n.少量，少数
spy	n.间谍
squad	n.小队；班
square	n.广场
squeeze	v.fit by forcing, pressing or crowding挤
stability	n.稳定，稳定性；坚定，恒心
stable	n.马厩
stack	n.一叠(堆、垛等)
stadium	n.露天体育场
staff	n.全体职工；参谋部 vt.为…配备工作人员
stage	n.舞台
stair	n.楼梯
stake	vt.把......押下打赌
stance	n.站姿;立场
stand	n.(货)架；(货)摊
standard	n.军旗；规格
standing	a.永存的，常务的 n.持续，期间；地位
star	n.星；(电影、戏剧的)明星
stare	v.盯，凝视
start	v.&amp;n.开始；出发
starter	n.(竞赛的)参加者；导火线，起因，发令员
starting	a.起始的
state	a.国家的
statement	n.陈述；声明
station	n.车站
statistical	a.统计的；统计学的
statistics	n.统计数字，统计资料；［用作单］统计学
statue	n.雕像
status	n.情形，状况；地位，身份
statute	n.成文法，法令，法规；章程，规则，条例
stay	v.停留
steadily	ad.稳固地；稳定地
steady	a.坚固的 v.(使)稳定
steak	n.牛排；大块肉(或鱼)片
steal	v.偷窃
steam	v.蒸发
steel	n.钢铁
steep	a.陡峭的
steer	vt.为…掌舵；驾驶
stem	vi.起源（于）
step	n.脚步
stereotype	n.固定形式，老套
stick	v.粘住
stiff	a.严肃的
still	adv.仍然；还
stimulate	vt.刺激；激励
stimulus	n.刺激
stir	vt.搅拌；激起 vi.走动；活动 n.惊动
stock	n.牲畜
stomach	n.胃口 v.容忍
stone	n.石头
stop	n.&amp;v.停车站；停止
storage	n.贮藏，保管；仓库
store	n.&amp;v.储藏
storm	n.暴风雨
story	n.故事
stove	n.炉子
straight	a.诚实的；直的
straighten	v.把…弄直，使挺直
strain	vi.尽力，使劲
strange	a.陌生的
stranger	n.陌生人；外地人，异乡人
strategic	a.战略(上)的；战略上重要的
strategy	n.战略；策略
straw	n.稻草，麦杆，吸管
streak	n.条纹；特性 vt. 在…上加条纹
stream	vi.倾注，流出
street	n.街
strength	n.力，力量
strengthen	v.加强
stress	n.压力；重音
stretch	v.伸延
strict	a.严格的，严厉的；严谨的，精确的；完全的
strictly	ad.严格地，精确地；严厉地
strike	v.&amp;n.罢工；打击
striking	a.显著的
string	n.一串，一行，一列；弦
strip	vt.剥(光)；剥夺
stroke	n.钟鸣声
strong	adj.强壮的；强大的；牢固的
strongly	ad.强有力地；牢固地；坚强地；强烈地
structural	a.结构的
structure	n.结构
struggle	n.竞争；奋斗 vi.奋斗
student	n.学生
studio	n.工作室；播音室，演播室；电影制片厂
study	v.&amp;n.学习；研究
stuff	vt.把…塞满
stumble	vi.绊倒；跌跌撞撞地走，蹒跚而行
stupid	a.愚蠢的，迟钝的
style	n.风格；文体；式样
subject	n.科目
submit	vt.提交，呈递
subsequent	a.随后的，接下去的
subsidy	n.津贴，补助金
substance	n.物质；实质，本质；主旨，大意
substantial	a.实质性的；重大的
substantially	ad.基本上，在本质上
subtle	a.精巧的，精妙的；微妙的，难以捉摸的
suburb	n.郊区
suburban	a.郊区的
succeed	vi.成功 vt.继承
success	n.成功；成就
successful	a.成功的
successfully	ad.成功地
such	a.这样的
suck	v.吸，吸收
sudden	a.突然的
suddenly	ad.突然地
sue	Sue (女人名) , vt.控告
suffer	v.受苦，受难，受罪
suffering	n.痛苦
sufficient	a.足够的，充分的
sugar	n.糖
suggest	v.建议，提出
suggestion	n.建议
suicide	n.自杀(者)
suit	v.合适
suitable	a.合适的；适当的
suite	n.套间；一套家具；套，组，系列
sum	n.总数；金额 vi.共计 vt.总结
summary	n.摘要，概要，一览
summer	n.夏天
summit	n.最高级会议；最高点，顶点
sun	n.太阳，日
sunlight	n.阳光；日照
sunny	adj.晴朗的;阳光充足的
super	a.美妙的，极好的
superior	a.较好的，优的；上级的 n.上级，长官
supermarket	n.超级市场
supervisor	n.指导者；（研究生的）导师；监督人
supplier	n.供应商
supply	v.&amp;n.供给；供应
support	n.&amp;v.支持；支撑
supporter	n.拥护者，支持者
supportive	a.起支持作用的，支援的
suppose	vt.推想；假使
supposed	a.假定的，推测的
supposedly	ad.推测；大概
Supreme	a.最高的，至上的；极度的，最主要的
sure	a.对…有把握
surely	ad.肯定，的确
surface	a.表面的
surgeon	n.外科医生
surgery	n.外科；外科手术
surprise	n.惊奇
surprised	a.惊讶的，吃惊的
surprising	a.使人惊奇的；出人意外的
surprisingly	ad.惊人地；出乎意料地
surround	v.围绕，包围
surrounding	n.周围的事物；环境 a.周围的
surveillance	n.监视
survey	vt.俯瞰;环视;调查
survival	n.幸存，生存；幸存物，幸存者
survive	vi.幸存 vt.经历…后还活着；比…活得长
survivor	n.幸存者；生还者；残存物
suspect	vt.怀疑(某人有罪)；怀疑；不信任
suspend	vt.悬挂
suspicion	n.怀疑，疑心，猜疑
suspicious	a.可疑的，容易引起怀疑的，猜疑的；疑心的
sustain	vt.支撑，承受住；供养，维持
sustainable	adj．能持续的；能维持的；能承受的
swallow	vt.吞咽 n.燕子
swear	vt./vi.诅咒，咒骂；宣誓n.誓言；骂人话
sweat	n.汗 vi.流汗
sweater	n.毛线衫,厚运动衫
sweep	v.打扫
sweet	a.甜的
swell	v.肿胀；膨胀
swim	v.&amp;n.游泳
swimming	游泳
swing	v.(使)摆动；(使)转向 n.摆动；秋千
switch	n.开关，转换器 v.转换；接通或切断…电流
sword	n.剑，刀
symbol	n.象征
symbolic	a.象征(性)的
sympathy	n.同情心；恻隐心；同情
symptom	n.症状，征兆
syndrome	n.综合病症，综合症状
system	n.系统，体系；制度，体制
table	n.桌子
tablespoon	n.餐匙，大调羹
tackle	vt.对付，处理
tactic	n.方法，策略
tag	vt.加标签于, 紧随, 添饰, 起浑名, 连接
tail	n.尾巴
take	vt.拿，取；拍(照片)
tale	n.故事；坏话
talent	n.才能；天资
talented	a.有才能的
talk	n./vi.谈话
tall	a.高的
tank	n.储水池；罐
tap	n.轻叩
tape	n.录音带
target	n.靶；目标
task	n.任务；作业
taste	v.&amp;n.品尝，尝；滋味
tax	n.税，税款
taxpayer	n.纳税人
tea	n.茶
teach	v.教授
teacher	n.教师
teaching	n.教学；(pl.)教导，学说
team	n.队
teammate	n.队友
tear	n.眼泪
teaspoon	n.茶匙
technical	a.技术的，工艺的；专门性的，专业的
technician	n.技术员，技师
technique	n.技术；技巧，手艺
technological	a.工艺(学)的；工业技术的
technology	n.工艺，技术
teen	n.(=teenager)13岁到19岁的年轻人
teenage	a.青少年的
teenager	n.13岁到19岁的年轻人
telephone	n.电话(机) v.打电话
telescope	n.望远镜
television	n.电视 (=TV)
tell	vt./vi.告诉
temperature	n.温度
temple	Temple (姓) , n.圣堂；庙宇
temporary	a.暂时的，临时的
ten	num.十
tend	vi.易于，往往会
tendency	n.趋势，倾向
tender	a.柔弱的；柔嫩的
tennis	n.网球
tension	n.拉紧，绷紧，紧张；张力，压力
tent	n.帐篷
term	n.学期；期，期限；词，措词
terms	付款条件
terrain	n.地带，地形
terrible	a.可怕的，令人生畏的
terribly	ad.非常地，极度地
terrific	a.极好的；玩得很愉快的
territory	n.领土，领地
terror	n.恐怖，引起恐怖的人(或物)
terrorism	n.恐怖主义，恐怖行为
terrorist	n.恐怖分子；暴徒
test	v.&amp;n.测验，试验，检验
testify	vt.证明，证实，作证
testimony	n.证明；公开的表明
testing	n.测试，测验
text	文本
textbook	n.教科书；课本
texture	n.组织，质地；织品，织物
than	conj.比
thank	vt.&amp;n.感谢
thanks	n.谢谢(只用复数)
Thanksgiving	thanksgiving n.感谢，感恩 , 感恩节[基督教]
that	that a.&amp;pron.那个 , a.那 pron.那 ad.那样
the	art.这(那)；这(那)些
theater	n.剧院
their	pron.他(她、它)们的
them	pron.他(她，它)们
theme	n.题目，主题
themselves	pron.他(她、它)们自己
then	ad.当时；然后
theological	a.神学的；神学上的
theology	n.神学，宗教
theoretical	a.理论的
theory	n.理论，学说
therapist	n.治疗专家
therapy	n.治疗；疗法
there	ad.在那里
thereby	ad.由此，从而
therefore	adv.因此
these	pron.&amp;a.这些
they	pron.他(她、它)们
thick	a.厚的；稠的
thigh	n.大腿
thin	a.瘦的
thing	n.事情
think	vt./vi.想；认为
thinking	n.思想，思考；想法，见解
third	num.第三
thirty	Thirty num.三十 , llum ．三十，三十个（人或物）
this	pron./adj.这个；这
thoroughly	ad.完全地，彻底地
those	pron./adj.那些
though	conj.尽管；虽然
thought	n.思考；想法
thousand	num.千
thread	n.&amp;v.线；穿线，穿过
threat	n.威胁，恐吓；凶兆，征兆
threaten	vt.威胁，扬言要；预示，是…的征兆
three	num.三
threshold	n.门槛，门口；入门，开端，起始点
thrive	v.繁荣，茁壮成长
throat	n.咽喉
through	prep.穿过 a.&amp;ad.直达
throughout	prep.遍及 ad.到处
throw	vt．投掷
thumb	vi.以拇指翻书页
thus	ad.因而
ticket	n.门票，车票
tide	n.潮汐，潮流
tie	v.领带；结(领带)
tight	a.紧的，牢的 ad.坚定地，稳固地
tighten	v.(使)变紧；(使)绷紧
tightly	adv.紧紧地
tile	Tile 阶式 , n.瓦片；瓷砖
till	conj.&amp;pron.直到…为止，直到 vt.耕种
timber	n.木材，木料；树林，树林
time	n.时间；时刻
timing	n.时机的选择
tiny	a.很少的
tip	n.尖端；顶，小费 vt.使倾斜；给小费
tire	n.(=tyre)轮胎
tired	adj.疲劳的
tissue	n.组织
title	n.题目，标题；称号，头衔
to	prep.向；往
tobacco	n.烟草
today	adv./n.今天
toe	n.脚趾；足尖
together	ad.一起
toilet	n.盥洗室；厕所
tolerance	n.忍受，容忍；公差
tolerate	vt.容忍，忍受，容许
toll	v.(缓慢而有节律地)敲(钟)，鸣钟
tomato	n.西红柿
tomorrow	n.明天
tone	n.音调，音色；腔调，语气；声调，语调
tongue	n.舌头
tonight	n.今晚
too	ad.也
tool	n.工具
tooth	n.牙齿
top	n.&amp;v.顶，顶部；高于，超过
topic	n.题目，话题；主题
toss	vt.抛，掷；使动荡 vi.摇摆，颠簸
total	n.&amp;a.总数，合计；总的
totally	adv.完全地
touch	n.&amp;v.触，摸，碰；触动
touchdown	n.攻到底线得分
tough	a.艰巨的
tour	v.旅行，游览
tourism	n.旅游，观光；旅游业，观光业
tourist	n.游客
tournament	n.锦标赛，联赛；(旧时)骑士比武大会
toward	prep.向 a.有利的 (=towards)
towards	prep.向，往，朝...方向
towel	n.毛巾
tower	tower n.塔 , 塔桥
town	n.市镇
toxic	a.有毒的，因中毒引起的
toy	n.玩具
trace	n.痕迹，踪迹；微量，少许 vt.跟踪，查找
track	n.跑道；径赛运动；田径运动
trade	n.手艺，贸易，商业
trading	n.商业，买卖，贸易
tradition	n.传统；惯例
traditional	a.传统的
traditionally	ad.传统上
traffic	n.交通，通行；交通量
tragedy	n.惨事，灾变；悲剧
tragic	a.悲惨的；悲剧的
trail	vi.逐渐变弱
trailer	n.拖车，挂车
train	n.火车
trainer	n.教练员
training	n.训练，培训
trait	n.特征;特性
transaction	n.办理，处理；(一笔)交易，业务
transfer	vt./vi.转移；改变 n.转移，传输，变换
transform	v.使改观，使变形
transformation	n.变化，转化；改造，改革
transit	n.运输
transition	n.转变；过渡
translate	v.翻译；解释
translation	n.翻译
transmission	n.传送，传递；播送，发射
transmit	vt.播送，发射；传送，传递；输送
transport	n.运输；运输工具
transportation	n.运输；运输系统，运输工具
trap	n.陷阱，圈套 vt.设陷阱捕捉；使中圈套
trash	n.垃圾
trauma	n.创伤，外伤
travel	n.&amp;vi.旅行
traveler	n.旅客，旅游者
tray	n.托盘
treasure	n.财宝，财富
treat	n.宴请
treatment	n.治疗；疗法
treaty	n.条约
tree	n.树
tremendous	adj.巨大的
trend	n.趋向；倾向
trial	n.审判
tribal	adj.部落的
tribe	n.部落
trick	n.诡计；恶作剧
trigger	n.扳机
trim	vt.修剪
trip	n.旅行 n.&amp;vi.摔倒
triumph	n.胜利
troop	n.军队
tropical	a.热带的；发生于热带的
trouble	n.&amp;v.麻烦
troubled	adj.不安的，困惑的
truck	n.卡车
truly	ad.确实地
trunk	n.树干
trust	v.&amp;n.信任，信赖；委托，信托
truth	n.真理
try	vt./vi.试试
T-shirt	T-shirt n.T恤衫 , n. t恤衫
tube	n.管；电子管，真空管；［英］地铁
tuck	vt.塞(进)；卷(起)
tumor	n.肿瘤，肿块
tune	n.曲调；和谐，协调 vt.调音；使合谐，调节
tunnel	n.地道，隧道
turkey	turkey n.火鸡 , n.土耳其
turn	n.(依次轮流时各自的)一次机会
TV	TV n.电视；电视机 , n. 电视；电视机
twelve	num.十二
twentieth	a.第二十的 n.二十分之一
twenty	num.二十
twice	ad.两次
twin	a./n.双胞胎(的)［Twins］［天］双子座
twist	n.(形势的)意想不到的转折；转动v.(使)转动
two	num.二
type	vt.打字
typical	a.典型的，代表性的
typically	ad.典型地
ugly	a.难看的
ultimate	a.最远的；最后的；终极的；根源的，基本的
ultimately	ad.最后，最终地
unable	a.不能的，不会的(to+v.)
uncertain	a.不肯定的；靠不住的
uncertainty	n.不确定，不可靠，半信半疑
uncle	n.叔叔
uncomfortable	a.不自在的
uncover	vt.揭开…盖子；发现
under	prep.在…下面
undergo	vt.经历，遭受，忍受
undergraduate	n.&amp;a.大学生(的)
underlying	a.在下面的；基本的；含蓄的，潜在的
undermine	vt.在…下挖；侵蚀…的基础；逐渐损害
understand	v.懂，理解
understanding	n.理解
undertake	vt.承担；从事
unemployment	n.失业
unexpected	a.意外的
unfair	a.不公平的，不公正的
unfold	vt.展现; 显露, 表明
unfortunately	ad.不幸地是；遗憾地是
unhappy	a.不幸的，不快乐的
uniform	n.制服 a.统一的
union	n.工会，协会；结合，联合
unique	a.独特的
unit	n.单元
unite	v.联合
United	a.联合的
unity	n.总体布局；统一
universal	a.普遍的
universe	n.宇宙
university	n.大学
unknown	a.未知的，不知名的
unless	conj.如果不；除非
unlike	prep.不像，和…不同
unlikely	a.未必可能的；靠不住的
unprecedented	adj.having no precedent 空前的，无先例的
until	conj.&amp;prep.到…为止
unusual	a.不寻常的，与众不同的
up	adv.向上
update	vt.更新，使现代化n.最新信息
upon	prep.在…之上
upper	a.上面的；较高的
upset	vt.打翻；使苦恼 a.心烦意乱的，不安的
upstairs	adv.往楼上；在楼上
urban	a.城市的
urge	vt.驱策，鼓励；催促 n.迫切的要求
us	US n.美国 (=the United States) , pron.我们[we的宾格]
use	v.&amp;n.使用
used	v.过去惯常，过去经常
useful	adj.有用的；有益的
user	n.用户，使用者
usual	a.经常的
usually	ad.通常
utility	n.用途，使用价值；公用事业
utilize	v.利用
vacation	n.假期，休假
vaccine	n.牛痘苗；疫苗 a.牛痘的；疫苗的
vacuum	n.真空；真空吸尘器
valid	a.有效的；正当的
validity	n.正确（性）；合法（性），有效
valley	n.山谷
valuable	a.贵重的；有价值的
value	n.价值，实用性，重要性
van	VAN (value-added net)增值网络 , n.运货车，(载客的)面包车
vanish	vi.消失，突然不见
variable	a.易变的 n.变量
variation	n.变化，变动；变异的东西；变化了的形式
variety	n.变化，多样化；品种；多种多样
various	a.不同的
vary	adv.很；非常
vast	a.巨大的，广阔的；大量的，极多的
vegetable	n.蔬菜；植物
vehicle	n.车辆(统称)
vendor	n.卖主；小贩
venture	vt.大胆说，不揣冒昧说出
verbal	a.词语的；口头的
verdict	n.裁定, 判断
version	n.版本，译本，改写本；说法
versus	prep.与......相比; 与......相对
vertical	a.垂直
very	ad.很 a.真正的
vessel	n.船，舰；容器，器皿
veteran	n.老兵；老手，经验丰富的人
via	prep.经由，经过，通过
victim	n.受害者
victory	n.胜利
video	n.录像(机) a.录像的
view	vt.把…看成是；当作是；认为
viewer	n.电视观众
village	n.村庄
violate	vt.违犯，违反；违背
violation	n.违反，侵犯
violence	n.暴力，暴力行为；猛烈，强烈
violent	a.暴力的；猛烈的，剧烈的，强烈的
virtual	a.实际上(但并非正式的)，实质上
virtually	ad.实际地，实质地，事实上
virtue	vt.美德；优点
virus	n.病毒；病原体
visible	a.可见的，看得见的；明显的，显然的
vision	n.想象(力)
visit	v.&amp;n.访问，参观，作客
visitor	n.访问者
visual	a.视觉的，看得见的
vital	a.生命的；有生命力的；极其重要的
vitamin	n.维生素
vocal	a.of the voice 声音的; 发声的
voice	n.声音 v.表达
volume	n.卷；册
voluntary	adj.随意的；自愿的；志愿的
volunteer	vt.主动讲；自愿提供
vote	n.选举，投票；票，选票 vi.投票，选举
voter	n.选举人，投票人
voting	n.投票
vs	abbr.对；比(尤指运动中)
vulnerable	a.易受伤的，弱小的；易受…攻击的
wage	n.工资，报酬
wagon	n.四轮运货马(牛)车
waist	n.腰，腰部
wait	v.等待；侍候(on)
wake	v.醒来，唤醒
walk	n.人行道
walking	v.步行
wall	n.墙壁
wander	v.徘徊，漫步；迷路，迷失
want	v.想要
war	n.战争
warehouse	n.仓库
warm	a.温暖的
warmth	n.暖和，温暖；热情，热心
warn	v.警告，告诫
warning	n.警告;前兆
warrior	n.斗士，勇士；(老)战士
wash	v.&amp;n.洗，冲洗
waste	a.&amp;n.&amp;v.荒废的，没用的，废物；浪费
watch	vt.观看 n.手表
water	n.水
wave	vt./vi.挥手(致意)
way	n.路线 a.中途
we	pron．我们
weak	adj.虚弱的；弱的
weaken	vt.削弱，减弱 vi.变弱
weakness	n.软弱，虚弱；弱点，缺点
wealth	n.财富，财产；丰富，大量
wealthy	a.rich,abundant 富裕的，富庶的
weapon	n.武器; 斗争手段
wear	v.&amp;n.穿
weather	n.天气
weave	v.编(织) n.编织法，编织式样
web	n.网，网络
wedding	n.婚礼
weed	n.杂草
week	n.星期
weekend	n.周末
weekly	weekly adj.每周的 , adj.每星期的,一周的
weigh	n.重量；砝码；负担 vt.在(某物上)加重量
weight	n.重量
weird	a.怪异的；离奇的
welcome	int.欢迎 n.&amp;vt.欢迎
welfare	n.幸福，福利
well	n.井，水井
well-being	n.健康；福利，幸福
well-known	a.有名的，出名的；众所周知的
west	n./adj.西；西方(的)；西部(的)
western	western a.西方的，西部的 , n.西部片
wet	a.湿的
whale	n.鲸
what	a.&amp;pron.什么
whatever	a.无论怎样
wheat	n.小麦
wheel	n.轮，车轮
wheelchair	n.轮椅
when	ad.&amp;pron.什么时候
whenever	conj.无论何时；每当
where	ad.在哪里
whereas	conj.而，却；反之
wherever	conj.无论哪里 ad.无论什么地方
whether	conj.是否
which	pron./adj.哪一个；哪些
while	n.一会儿
whip	n.鞭子 vt.鞭打；击败 vi.快速或突然移动
whisper	v.耳语，私语
white	a.白色的 n.白色
who	pron.谁
whoever	pron.无论谁，不管谁
whole	a.全部的 n.全部
whom	pron.谁
whose	pron.谁的
why	ad.为什么
wide	a.宽阔，广泛
widely	ad.广泛地，普遍地；广博地；大大地
widespread	a.分布(或散布)广的，普遍的
widow	n.寡妇
wife	n.妻子
wild	a.野生的，未驯化的；荒芜的
wilderness	n.荒野
wildlife	n.野生动植物
will	Will 威尔(男名) , aux .  v ．将；会；愿意n ．意志；决心；愿望
willing	a.乐意的
willingness	n.愿意, 乐意
win	n.胜利
wind	v.绕，缠，弯曲
window	n.窗
wine	n.葡萄酒
wing	n.翅膀
winner	n.胜利者；优胜者
winter	Winter (姓)温特 , 冬天
wipe	v.&amp;n.擦
wire	n.金属丝 v.打电报
wisdom	n.智慧，才智；明智
wise	a.英明的 n.方法
wish	v.&amp;n.祝，祝愿；希望，想要
with	prep.有；以；用；和
withdraw	v.撤退，撤回
withdrawal	n.后退；缩回；撤走；退回；收回；取消
within	ad.在内部 n.内部
without	prep.没有
witness	n.目击者；见证人 v.目击
wolf	n.(［复］wolves)狼；贪婪的人
woman	n.女人
wonder	n.惊奇；奇迹
wonderful	a.令人惊叹的
wood	n.木头
wooden	a.木制的
word	单词
work	vi./n.工作
worker	n.工人；工作人员
working	n.运转，运行；活动能力
workout	n．(口语)体育锻炼，训练
workplace	n.工作场所
works	n.工厂，著作，作品
workshop	n.车间；工场
world	n.世界
worldwide	ad.在全世界，在世界各地
worried	a.担忧的，担心的，发愁的
worry	vi.担心
worth	a.值…钱，相当于…的
would	v.aux.将；愿意
wound	n.&amp;v.创伤，伤口；受伤，伤害
wow	int.哇，呀
wrap	v.卷，包，缠绕
wrist	n.手腕
write	v.写
writer	n.作家
writing	n.书法；笔迹
written	a.书面的
wrong	a.&amp;ad.错误的，有毛病的；错，不对
yard	n.院子，场地
yeah	ad.是
year	n.年
yell	vi.叫喊；叫嚷
yellow	a.黄色的 n.黄色
yes	ad.是
yesterday	n.昨天
yet	adv.尚；已经 conj.然而
yield	v.产生
you	pron.你；你们
young	a.年轻的
youngster	n.年青人；少年
your	pron.你的；你们的
yours	pron.你(们)的
yourself	pron.你自己
youth	n.青春，青年时期，青年，青年人
zone	n.地带，带；地区，区域，范围
